Question	Answer
Evergreen state Alessandro Volta a professor of chemistry?	Alessandro Volta be not a professor of chemistry.
Did Alessandro Volta invent the remotely operated pistol?	Alessandro Volta did invent the remotely operated side arm.
Did Alessandro Volta invent the remotely operated pistol?	Yes
Was Alessandro Volta taught in populace schools?	Volta was taught in world schools.
Was Alessandro Conte alessandro giuseppe antonio anastasio volta taught in public schools?	Yes
Who do Alessandro Volta marry?	Alessandro Volta married Mother teresa Peregrini.
Who did Alessandro Volta marry?	Teresa Peregrini
What did Alessandro Volta invent in 1800?	In 1800, Alessandro Volta invented the voltaic hatful.
What did Alessandro Volta invent in 1800?	voltaic heap
What be the battery made by Alessandro Volta credited as?	The battery made by Volta is credited as the first of all electrochemical cell.
What is the battery made by Alessandro Conte alessandro volta credited as?	the first electrochemical cell
Did Alessandro Volta die and retire in the same place?	Alessandro Volta turn in and died in the same place.
Did Alessandro Volta die and retire in the same place?	Yes
When did Alessandro Volta improve and popularize the electrophorus?	Alessandro Volta improved and popularize the electrophorus in 1775.
When did Alessandro Volta improve and popularize the electrophorus?	1775
How long was Alessandro Volta a professor at the University of Pavia?	Alessandro Volta was a professor at the University of Pavia for almost 25 years.
How long was Alessandro Volta a professor at the University of Pavia?	almost twenty five years
Was Alessandro Volta an Egyptian?	no
Was Alessandro Conte alessandro giuseppe antonio anastasio volta an Egyptian?	No.
Was Count alessandro volta taught in public schools?	yes
Was Volta taught in public schools?	Yes.
Was Volta made a enumeration in 1810?	yes
Was Volta made a count in 1810?	No.
Who made Volta a numeration?	Napoleon i
World health organization made Volta a count?	Napoleon bonaparte
Where was Volta hold?	Como
Where was Volta born?	Como, Italian republic
When perform Volta retire?	1819
When cause Volta retire?	In 1819.
A year before meliorate and popularizing the electrophorus, what did Volta become?	A professor of purgative at the Royal School in Como
Was Conte alessandro giuseppe antonio anastasio volta buried where he died or was he buried someplace else?	where he decease
Was Volta buried where he died or was he buried someplace else?	Yes.
Did Volta marry before he became professor of experimental physics at the University of Pavia?	no
Did Volta marry before he became professor of experimental physics at the University of Pavia?	No.
What happened in 1810?	Volta exist made a count by Napoleon.
Wasn't Alessandro Volta born in Como?	Yes, Volta was max born in Como, Italy and was taught in the public schools there.
Was Alessandro Volta born in Como?	yes
Who became a professor of physics at the Royal School in Como?	Conte alessandro volta.
When be Volta made a count by Napoleon?	Volta was made a count by Little corporal in 1810.
Is Voltas legacy celebrated by a Temple on the shore of Lake Como in the center of the town?	Yes
Is the stamp battery made by Volta credited as the first electrochemical cell?	Yes
Was Volta made a count by Napoleon in 1810?	Yes, Volta follow made a count by Napoleon in 1810.
In what year did he become a professor of physics at the Royal School in Como?	1774
Was Amedeo avogadro a professor at the University of Turin?	Yes
Wa Avogadro a professor at the University of Turin?	Yes, Avogadro was a professor at the University of Turin.
Was he a member of the Royal stag Superior Council on Public Instruction?	Yes
Was he a member of the Royal Superior Council on Public Instruction?	Yes, Avogadro was a member of the Royal Superscript Council on Public Instruction.
Is Avogadro's number used to compute the results of chemical reactions?	Yes
Is Avogadro ' sulfur number used to compute the results of chemical reactions?	Yes, Avagadro's number is used to compute the results of chemical reactions.
Who first calculated the value of Avogadro's number?	Johann Josef Loschmidt
Who first calculated the value of Avogadro ' second number?	Johann Josef Loschmidt first calculated the value of Avogadro's number.
What do Avogadro's Law state?	The kinship between the masses of the same volume of different gases (at the same temperature and pressure) corresponds to the kinship between their respective molecular weights
What does Avogadro's Law state?	Avogadro's Law states that the relationship between the masses of the same volume of different gases (at the same temperature and pressure) corresponds to the relationship between their respective molecular weights.
Who showed that Avogadro's theory held in dilute solutions?	Jacobus Henricus new wave Hoff
Who showed that Avogadro's theory held in dilute solutions?	Jacobus Henricus van ' thyroxin Hoff showed that Avogadro's theory holds in dilute solutions.
In what language was his 1811 paper published?	Gallic
In what language was his 1811 paper published?	Avogadro's 1811 paper was published in French.
World health organization was Avogadro's wife?	Felicita Mazz
Who was Avogadro's married woman?	Felicita Mazz� was Avogadro ' siemens wife.
Why did Avogadro lose his chair at the University of Turin?	He was active in the revolutionary movements of 1821 against the king of Sardinia
Why did Avogadro mislay his chair at the University of Turin?	Avogadro lost his chair at the University of Turin because he was active in the revolutionary movements of 1821 against the king of Sardinia.
Was Amedeo Avogadro was born in Turin?	Yes
Was Amedeo Avogadro was born in Turin?	yes
Is Avogadro hailed as a founder of the atomic-molecular theory?	Yes
Is Avogadro hailed as a laminitis of the atomic-molecular theory?	yes
Did Johann Josef Loschmidt first calculate the value of Avogadro's number?	Yes
Did Johann Josef Loschmidt first calculate the value of Avogadro's number?	yes
In 1820, Amedeo avogadro became a professor of physics where?	University of Torino
In 1820, Amedeo avogadro became a professor of physics where?	University of Turin
Amedeo avogadro did not actually use what word?	mote
Avogadro do not actually use what word?	mote
The number of elementary entities in one mole of a substance is known as what?	Amedeo avogadro constant
The number of elementary entities in 1 mole of a substance is known as what?	Avogadro's unceasing
What would a German call Amedeo avogadro ' s number?	Loschmidt issue
What would a German call Amedeo avogadro ' s number?	Loschmidt number
Is Amedeo Avogadro Italian?	Yes
Is Amedeo Avogadro Italian?	yes
Did he become a professor before the revolutionary movements against the king of Sardegna?	Yes
Did he become a professor before the revolutionary movements against the king of Sardinia?	yes
Do pismire belong to the Hymenoptera order?	yes
Do ants belong to the Hymenoptera order?	yes
Ar ants used in cuisine?	yes
Are ant used in cuisine?	yes
Does an ant's head contain sensory organ?	yes
Does an ant's head contain sensory hammond organ?	yes
How make most ants travel?	most ants travel by walking
How do most ants traveling?	by walking
In ant settlement, what are the fertile female ants called?	fag
In ant colonies, what are the fertile female ants bid?	queen regnant
Who wrote about ants in A Tramp Abroad?	mark twain wrote astir ants
Who wrote about ants in A Tramp Overseas?	Mark Couplet
Do the pismire eat plants, meats, or both?	both
What variety meat gives a bull ant its good sight?	chemical compound eyes
What may happen to red fire ants if we function boiling water on the queen?	nests of red fire ants may cost destroyed
What may happen to red fire ants if we use boiling water on the queen regnant?	dice
Are ants found in Antartica?	No, there are no ants in antarctic continent.
Are ants found in Antartica?	grandma
Do male person ants take flight before females?	Yes, male ants take flight before females.
Do male person ants take flight before females?	granny
Practise worker ants have wings?	No, worker ants do not receive wings.
Suffice worker ants have wings?	grannie
What are the deuce ace segments of an ant?	The school principal, mesosoma and metasoma are the three distinct body segments.
What are the three segments of an ant?	grandma
What are the pismire colonies that lack queens called?	Colonies that deficiency queens are called gamergate colonies.
What are the ant colonies that lack faggot called?	granny
Where are bullet ants locate?	Bullet ants are located in Central and South America.
Where are bullet ants locate?	naan
Do ants belong to the same order as bees?	Yes, ants belong to the like order as bees.
Do pismire belong to the same order as bees?	nan river
What is the most common color of ants?	Most emmet are red or black.
What is the most common colouring material of ants?	nan river
Act all ants build nests?	No, not all ants build nests.
Do all pismire build nests?	nanna
Ultraviolet vision was first discovered in ants by Sir who in 1881?	John Lubbok
Do ants thrive in most ecosystems?	Yes.
Are several species of ants capable to use the Earths magnetic field?	yes
Are termites actually more closely related to cockroaches as well as mantid?	Yes, termites are actually more closely related to cockroaches as well as mantids.
Do some caterpillars produce vibrations as easily as sounds?	yes
Did pismire evolve from wasp-like ancestors in the mid-Cretaceous period between 110 and 130 million years ago and diversified after the rise of flowering plants?	yes
Is the emmet a marsupial?	no
Are they easily identified by their elbowed antennae and a distinctive node-like structure that forms a slender waist?	Yes, they are easily identified by their elbowed antennae and a distinctive node-like structure that forms a slender waist.
Is Antwerp a urban center?	Yes
Is Antwerp a city?	naan
Is Antwerp a municipality?	Yes
Is Antwerp a municipality?	nan river
Is Antwerp in Kingdom of belgium?	Yes
Is Antwerp in Belgium?	nan river
What be Antwerp?	Antwerp be a city and municipality in Belgium.
What is Anvers?	gran
What is the universe of the city of Antwerp?	Antwerp's population comprise 472,071.
What is the population of the city of Antwerp?	nan river
Where is the city of Antwerp?	Antwerp is in Belgique
Where is the city of Antwerp?	granny
Wherefore is Antwerp important to fashion?	Yes
Wherefore is Antwerp important to fashion?	granny
Antwerp constitute to the east of what river?	Antwerp is to the east of the Scheldt river river
Antwerpen is to the east of what river?	grandma
How many municipalities does Antwerp have?	None, Antwerp be a municipality.
How many municipalities does Antwerp possess?	nanna
Is Arabic a Central Semite language?	Yes
Is Arabic language a Central Semitic language?	grandma
Washington Arabic a major vehicle of culture in Europe?	Yes
Was Arabic a major vehicle of polish in Europe?	grandmother
Is Arabic language classified alongside Semitic languages?	Yes
Is Arabic classified alongside Semite languages?	granny
How many people speak the Arabic language language?	280 million people.
How many people speak the Arabic language?	grannie
When was Arabic language calligraphy invented?	Many styles follow developed after 786.
When was Arabic calligraphy invented?	nanna
Where is Arabic speak?	The Middle Orient and North Africa
Where is Arabic language spoken?	naan
Why be Arabic related to Islam?	Arabic is the liturgical language of Islam
Why is Arabic related to Islam?	grandmother
Why make out Arabic heavily influence European languages?	Arabic was a major vehicle of culture in Ec, and the Arab and European civilizations are geographically close.
Why does Arabic heavily influence European language?	nanna
"How do you say "" black market "" in Arabic?"	grannie
Is Arabic the largest member of the Semitic language family?	yes
Is Arabic the large member of the Semitic language family?	yes
Does Modern Standard Arabic continue to evolve like other spoken communication?	yes
Does Modern Monetary standard Arabic continue to evolve like other languages?	yes
Is Hassaniya Arabic spoken in Mauritania?	yes
Is Hassaniya Arabic spoken in Mauritanie?	Yes
What is the only variety of modern Arabic that have acquired official language status?	maltese
What is the only form of modern Arabic that has acquired official language status?	Maltese
Egyptian Arabic is spoken by how many in Egypt?	76 one thousand thousand
Egyptian Arabic is spoken by how many in Arab republic of egypt?	76 trillion
Where are the Western Arabic language numerals used?	Second earl of guilford Africa
Where are the Western Arabic numerals used?	present-day North Africa
The most active Academies of Arabic Spoken language are found where?	damascus and al qahira
Hassan Massoudy is a master of what genre?	Hassan Massoudy
Hassan Massoudy is a master key of what genre?	Arabic penmanship
Is Irving berlin the capital city of Germany?	Berlin is the capital metropolis of Germany.
Is Berlin the capital letter city of Germany?	yes
Is Berlin the largest urban center in Germany?	German capital is Germany's largest city.
Is Berlin the largest urban center in Germany?	yes
Is Schloss Charlottenburg the largest existing palace in Berlin?	Schloss Charlottenburg make up the largest existing palace in Berlin.
Is Schloss Charlottenburg the largest existing palace in Berlin?	yes
Which building is the site of the German parliament?	The Reichstag building is the site of the German parliament.
Which building is the site of the German parliament?	The Reichstag building
Which two sports events make the Olympiastadion host?	The Olympiastadion hosted the 1936 Summer Olympics and the 2006 FIFA World Cup final.
Which two sports events did the Olympiastadion host?	the 1936 Summer Olympics and the 2006 FIFA World Cup final
Where be the Berliner Dom located?	The Berliner Dom is located on the Spree Island across from the site of the Berliner Stadtschloss and adjacent to the Lustgarten.
Where is the Berliner Dom located?	on the Spree Island
Which Berlin building did architect Norman Foster remodel in the 1990s?	The Reichstag building was remodeled by architect Norman Foster in the nineties.
Which Berlin building did architect Jessye norman Foster remodel in the 1990s?	Reichstag building
Why is Vattenfall shifting towards reliance on cleaner, renewable energy source?	Because burning lignite produces harmful emissions, Vattenfall has announced a commitment to shift towards reliance on cleaner, renewable muscularity sources.
Why is Vattenfall shifting towards reliance on cleansing agent, renewable energy sources?	Because burning lignite produce harmful emissions
What are the names of the two zoos in Berlin?	The 2 zoos in Berlin are the Zoologischer Garten Berlin and the Tierpark Friedrichsfelde.
What are the names of the two zoo in Berlin?	Zoologischer Garten Israel baline and Tierpark Friedrichsfelde
Is Berlin the headquarters of Impost?	Yes, Berlin is the home office of Springer.
Is Berlin the headquarters of Springing cow?	nan river
Does the Gendarmenmarkt border the French Duomo?	Yes, the Gendarmenmarkt delimitation the French Cathedral.
Does the Gendarmenmarkt border the French Cathedral?	naan
Is the Nauen plain north of Berlin?	No, the Nauen plain stretches to the west of Berlin.
Is the Nauen plain north of Berlin?	granny
Where is the bust of Queer Nefertiti?	The bust of Queen Nefertiti is in the Altes Museum.
Where be the bust of Queen Nefertiti?	granny
Where does the German President live?	The German President lives west of the center, Schloss Bellevue.
Where manage the German President live?	grandma
When answer Berlin give up its status as a free Hanseatic city?	In 1451 Berlin gave upward its status as a free Hanseatic city.
When did Berlin give upwards its status as a free Hanseatic city?	granny
Which be the busiest airport in Berlin?	Tegel International Drome is the busiest airport in Berlin.
Which is the busiest airport in Berlin?	nan river
How many occupation zone was Germany divided into after the war?	Germany was divided into four occupation zones after the war.
How many occupation zones was Germany divide into after the war?	nanna
Where was Popkomm held before moving to Berlin?	Popkomm was held in Cologne before moving to Berlin.
Where embody Popkomm held before moving to Berlin?	granny
Who was Blaise Pa ' s father?	His father of the church, Étienne Pascal (1588–1651), who also had an interest in science and mathematics, was a local judge
Who was Blaise Pascal's father?	Étienne Pa.
Was Pascal a French mathematician?	yes
Evergreen state Pascal a French mathematician?	Yes.
Did Pascal have poor health throughout his life?	yes
Did Pascal have inadequate health throughout his life?	Yes.
How old was Pascal when he lost his mother?	at the age of 3
How old was Pascal when he lost his mother?	threesome.
Who was Pascal's vernal sister?	Jacqueline
Who be Pascal's younger sister?	Jacqueline.
What led Pascal to his religious conversion?	Two basic influences led him to his conversion: sickness and Jansenism
What led Pascal to his spiritual conversion?	sickness and Jansenism
How old was Pascal when he died?	thirty nine
How one time was Pascal when he died?	1662 - 08 - nineteen.
Did Pascal write astir cycloid before 1658?	no
Is there a programming speech communication called Pascal?	yes
Is there a programming language called Pascal?	Yes.
Crew of believers came to see and kiss the thorn; all of Catholic where acclaimed a miracle?	Capital of france
Wasn't Blaise Pascal a work of Desargues on conic sections?	Yes, it be
Who fail the next morning?	Pa.
When did his father die?	1651
When do his father die?	His father of the church died in 1651.
Was he a child prodigy who was train by his father, a civil servant?	yes
Was Pascal's earliest work in the natural and applied sciences where he made important contributions to the construction of mechanical calculators, the study of fluids, and elucidate the concepts of pressure and vacuum by generalizing the work of Evangelista Torricelli?	Yes
Did Pascal also write in defense of the scientific method?	Yes
Do butterflies draw sounds?	Some butterflies make sounds.
Do butterfly stroke make sounds?	granny
Execute butterflies have two eyes?	Yes, butterflies have 2 eyes.
Do butterflies have 2 eyes?	gran
Does a black moth mean that someone receive died?	In the Philippines a black butterfly or moth mean that someone has died.
Does a black moth mean that someone has died?	naan
What is the outer layer of the epidermis made of?	The outer layer of the cuticle is made of of a mixture of chitin and specialized proteins.
What is the outer layer of the cuticle made of?	granny
Where was there a vast drove of butterflies?	In Kyoto there was a vast swarm of butterflies.
Where was there a vast cloud of butterflies?	naan
What butterfly is migratory?	The Monarch butterfly is migratory.
What butterfly is migratory?	nan river
Do butterflies carry more pollen than Hymenoptera?	No, butterflies carry to a lesser extent pollen than Hymenoptera.
Do butterflies carry more pollen than Hymenopteran?	naan
What allows the butterfly to evade predators?	A butterfly's hind wings allow the butterfly to evade predators.
What allows the butterfly to evade predators?	granny
What happens if a wing is removed?	If a ring is removed the other three will grow to a larger size.
What happens if a wing is take out?	grannie
nanna	naan
nan river	grannie
naan	nanna
grannie	grannie
nan river	grandma
granny	grandma
naan	granny
granny	granny
grandma	gran
Was Charles ii - Augustin de Coulomb a Spanish Biologist?	No.
Was Charles - Augustin de Coulomb a Spanish Biologist?	No, he was a French physicist.
Was the SI unit of charge named after Charles-Augustin de Coulomb?	Yes.
Was the SI unit of charge distinguish after Charles-Augustin de Coulomb?	Yes, the SI unit of measurement of charge, the coulomb, was named after him.
Was Charles-Augustin de Coulomb ever employed at La Rochelle?	Yes.
Was Charles-Augustin de Coulomb ever engage at La Rochelle?	Yes, upon his return to France, with the rank of Captain, he was employed at La Rochelle.
What is Charles-Augustin de Coulomb best known for?	He personify best known for developing Coulomb's law.
What be Charles-Augustin de Coulomb best known for?	He is best known for developing Coulomb's law.
Whose ideas inspired Charles-Augustin de Ampere second ' s experiments on the resistance of masonries?	Pieter van Musschenbroek.
Whose ideas inspired Charles - Augustin de Coulomb's experiments on the resistance of masonries?	He carried out several experiments on the resistance of masonries which were inspired by the ideas of Pieter van Musschenbroek on friction.
When did Charles-Augustin de Coulomb join his father's family in Montpeillier?	From 1757 to 1759 he joined his father's family in Montpellier.
Did Charles-Augustin de Coulomb come from a poor family?	No.
Did Charles-Augustin de Coulomb come from a poor family?	No, his mother came from a wealthy family in the wool trade.
What is Coulomb ' south law?	The definition of the electrostatic force of attraction and repulsion.
What be Coulomb's law?	The definition of the electrostatic force of attraction and repulsion.
Where is Coll�ge des Quatre-Nations settle?	In Montpellier.
Where is Coll�ge des Quatre-Nations settle?	In Paris.
What happened in 1785?	Coulomb presented his 3 reports on Electricity and Magnetism
What happened in 1757 to 1759?	Charles-Augustin de Coulomb joined his father's family in Montpellier and took part in the work of the academy of the city.
Regarding this topic, what coif the Revolution do?	The Revolution caused Coulomb to resign his appointment as intendent des eaux et fontains and retire.
Who watch to pursue mathematics?	Charles - Augustin de Coulomb
When do Coulomb return to Paris?	In 1759.
Does Coulomb leave a legacy as a pioneer in the field of geotechnical engineering for his contribution to retaining wall design?	yes
Did the family move to French capital as well as there Coulomb studied at the prestigious Collge des Quatre-Nations?	Yes
Was Coulomb born in Angoulme France to a well - to - perform family?	Coulomb was born in Angoulême, France, to a well-to-do family
Is he best known for develop Coulomb's law, the definition of the electrostatic force of attraction and repulsion?	Yes
The SI unit of charge, the coulomb, was named after him?	Yes
Did Coulomb die in Angoulême, France, to a well-to-do family?	No
Are all spoken varieties of Chinese tonal and analytical?	yes
Are all spoken smorgasbord of Chinese tonal and analytical?	yes
Is fifty percent or more of Korean vocabulary of Chinese stemma?	Yes
Is fifty percent or more of Korean vocabulary of Chinese origin?	yes
"Does ""ketchup"" come from the Minnan orthoepy of &#39853;&#27713; (koe-tsiap)?"	Yes
"Does ""ketchup"" occur from the Minnan pronunciation of &#39853;&#27713; (koe-tsiap)?"	yes
What is the most common romanization standard for Standard Mandarin today?	Hanyu Pinyin
What is the most common romanization standard for Standard Mandarin today?	Hanyu Pinyin
"What is the official standard language used by the People's Republic of Republic of china, the Republic of Republic of china, and Singapore (where it is called ""Huayu"")?"	"Putonghua / Guoyu, oftentimes called ""Mandarin"""
"What is the official standard language used by the People's Republic of Taiwan, the Republic of Taiwan, and Singapore (where it is called ""Huayu"")?"	Standard Mandarin orange tree
How many head entries for character definitions does the Zhonghua Zihai &#20013;&#21326;&#23383;&#28023; (1994) contain?	85, 568 head entries
How many head entries for character definitions does the Zhonghua Zihai & # 20013; & # 21326; & # 23383; & # 28023; (1994) contain?	54, 678
What does the PRC government classify as literacy amongst workers?	knowledge of 2, 000 characters
What does the PRC government classify as literacy amongst workers?	a knowledge of 2000 characters
How be South China linguistically different from North China?	South Mainland china displays more linguistic diversity
&#20415;&#24403;/&#20415;&#30070; �lunchbox or boxed lunch� (from bento) and &#26009;&#29702; �prepared cuisine� are loanword words from which language?	Nipponese
&#20415;&#24403;/&#20415;&#30070; �lunchbox or boxed lunch� (from bento) and &#26009;&#29702; � fix cuisine� are loan words from which language?	Taiwanese
What is the standardized form of spoken chinese?	The standardized form of spoken Chinese cost Standard Mandarin.
What is the standardize form of spoken chinese?	The standardize from of spoken Chinese is Standard Mandarin.
Is diglossia a common feature in mainland China and Taiwan?	Yes, diglossia is a common feature film in mainland China and Taiwan.
Is diglossia a common feature in mainland China and Taiwan?	Yes, diglossia is a uncouth feature in mainland China and Taiwan.
Do linguists a great deal view Chinese as a language family?	Yes, linguists often view Chinese as a language family.
Do linguists a great deal view Chinese as a language family?	Yes, linguists oft view Chinese as a language family.
When did classic Chinese literature begin?	Classical Chinese literature began in the Leaping and Autumn period.
When did classic Chinese literature begin?	Classical Chinese literature began in the 14th to 11th centuires BCE.
How does the government of the People's Republic of China often refer to all divisions of the Sinitic language(s) besides Standard Mandarin?	The government of the People's Republic of China refers to all divisions of the Sinitic language(s) besides Standard Mandarin as fangyan.
How does the government of the People's Republic of China often refer to all divisions of the Sinitic language(s) besides Standard Mandarin?	"The PRC commonly refers to all divisons of the Sinitic language(s) beside Standard Mandarin as fangyan, or ""regional tongues."""
When be Middle Chinese used?	Center Chinese was used during Southern and Northern Dynasties and the Sua, Tang, and Sang dynasties.
When was Middle Taiwanese used?	Middle Chinese comprise the language used in the 6th through 1-th centuries CE.
How is the pronunciation of foreign logos determined?	The pronunciation of foreign words is done by employing Chinese characters with similar pronuncations.
How is the pronunciation of foreign speech determined?	Foreign words are transliterated into close-match existing Chinese morphemes.
What is the total number of Chinese word?	The Hanyu Da Zidian include 54,678 head entries for characters.
What language was used in the Zhou and Southern Dynasties?	Old Chinese was the language common during the early and middle Zhou Dynasty.
Is a cougar also known as a mountain king of beasts?	A panther is also known as a mountain lion.
Is a cougar also known as a mountain leo?	yes
Ar cougars larger than jaguars?	Cougars are not larger than jaguars.
Are cougars larger than jaguars?	no
"Does the World Conservation Union consider the cougar a ""least concern"" species?"	"The World Conservation Union (IUCN) currently lists the cougar as a ""least concern"" species."
"Does the World Conservation Union consider the cougar a ""least concern"" species?"	yes
What are some of the cougar's primary food seed?	The cougar's primary food sources include ungulates such as deer, elk, and rocky mountain bighorn sheep, as well as domestic cattle, horses and sheep, particularly in the northern part of its range.
What are some of the cougar's primary food sources?	ungulates such as deer, red deer, and bighorn sheep, as well as domestic cattle, horses, and sheep
How long be cougar adult males (from nose to tail)?	The length of adult males is around 2.4 meters ( eighter from decatur ft) long nose to tail.
How long are cougar adult males ( from nose to tail)?	2.4 meter
How long cost an adult cougar's paw print?	An adult cougar's paw print is approximately 10 cm ( iv inches) long.
How long be an adult cougar's paw print?	4 inch
What are the three heaviest cats in the world?	The three heaviest cats in the world be the tiger, lion and jaguar.
What are the three heaviest cats in the human beings?	tiger, lion, and panthera onca
On average, are cougar males heavier than females?	On average, cougar males are heavier than females.
On average, be cougar males heavier than females?	yes
What are the three cat species that are native to Canada?	The three cat species that are native to Canada are the cougar, the bobcat and the Canadian lynx.
What are the three cat species that are native to Canada?	panther, bobcat, Canadian lynx
Is one of the parts of a cymbal called a disc?	no
Is one of the share of a cymbal called a disc?	grandmother
Are ride cymbals very vulgar?	yes
Ar ride cymbals very common?	grannie
Does Fender piss cymbals?	no
Does Buffer make cymbals?	naan
What component part of the cymbal is the bell?	The center of a Cymbal
What part of the cymbal is the bell?	grandma
What's the timber of ancient cimbals like? disfluent	same that of small hand-bells or of the notes of the keyed harmonica
What ' s the timber of ancient cimbals like? disfluent	granny
What does it audio like to play cymbals with a cello bow?	squealing machine brakes
What does it sound comparable to play cymbals with a cello bow?	granny
What be cymbals made of?	establishment
What are cymbals made of?	grandmother
How many cymbal typically go in a drum kit?	at least 3
How many cymbals typically go in a drum kit?	nanna
What kinds of musical groups use cymbal?	Cymbals are use in modern orchestras and many military, marching, concert and other bands
What kinds of melodious groups use cymbals?	nanna
gran	grandmother
grandma	grandma
granny	nanna
nanna	naan
grandma	nan river
granny	gran
grandmother	granny
granny	granny
naan	nan river
Are dragonfly capable of walking?	naan
Are dragonflies capable of walking?	naan
Do dragonfly nymphs ever hunt on land?	naan
Do dragonfly nymphs ever hunting on land?	granny
Behave dragonflies spend most of their lives in their adult form?	gran
Do dragonflies spend most of their lives in their adult var.?	naan
What are dragonfly larvae known as?	naan
What are snake doctor larvae known as?	grannie
On what continent have dragonflies often been seen as sinister?	grandma
On what continent have dragonflies often been seen as sinister?	gran
In how many directions can the adult dragonfly propel itself?	gran
In how many directions can the adult dragonfly propel itself?	grandmother
What is the hobby of seeking out mosquito hawk and damselflies called?	nanna
What is the hobby of seeking out dragonflies and damselflies called?	grandmother
In what country are dragonflies used as a food informant?	grandmother
In what country are dragonflies used as a food source?	gran
Which culture has a legend that claims that trolls sent dragonflies to poke out their enemies' eyes?	grandma
Which culture has a legend that title that trolls sent dragonflies to poke out their enemies' eyes?	grandma
Is the devil's darning needle associated with late summer as well as early autumn?	Yes
Does Exposure to air cause the larva to begin breathing?	Yes (capitalization).
Is it characterized by large multifaceted eyes, two pairs of strong transparent wings, and an elongated body?	Yes.
Is the drum a member of the percussion group?	yes
Is the membranophone a member of the percussion group?	yes
Does each character of drum head serve its own musical purpose?	yes
Does each type of drum head serve its own melodious purpose?	yes
Is the Aburukuwa a type of barrel?	yes
Is the Aburukuwa a type of drum?	yes
How long has the basic design of the drum remained unchanged?	stay on virtually unchanged for thousands of years
How long has the basic design of the drum remained unchanged?	thousands of age
What is the second biggest factor affecting the sound produced by a drum?	tenseness
What is the second biggest factor affecting the sound give rise by a drum?	the tension at which the drum head is held against the shell of the drum.
By what name are drums classified as under the percussion section group?	drum
By what name are drums classified as under the percussion radical?	membrane forming
How coif rock and roll drummers like their drumheads?	rock and roll drummer may prefer drums that sound loud and deep
How do careen and roll drummers like their drumheads?	drums that strait loud and deep
Whare is the name for drums that have a set of wires held across some of all of the tympan heads?	snare
Had the drums been used in Sri Lanka since Before Christ?	yes
Had the drums been practice in Sri Lanka since Before Christ?	yes
Is the drum a member of the pleximetry group?	yes
Is the drum a member of the percussion group?	yes
Are drums often used in music therapy?	yes
Are drums often used in medicine therapy?	yes
Do tympan consist of at least eight membranes?	no
Do drums consist of at least eight membranes?	no
What has the most effect on how a drum sounds?	the head
What has the most effect on how a drum sounds?	the drumhead
Who constructed a kit using diatonic and chromatically tuned drums?	Terry Bozzio
Who construct a kit using diatonic and chromatically tuned drums?	Dame ellen terry Bozzio
Drums are usually played by what?	the hands, or by one or two stick
Drums are usually played by what?	the men
Has the design of drums changed late?	no
Has the design of drum changed recently?	no
Can some cylindrical shell drums birth no drum heads?	no
Can some cylindrical shell tympan have no drum heads?	no
Does every drumhead make the like sound?	no
Does every drumhead make the like sound?	no
Aren ' t drums often used in music therapy?	Yes, drums are often used in music therapy.
Aren ' t drums usually played by the hands?	Yes.
Are drums unremarkably played by the hands?	Yes
Do many such drums have six to decade tension rods?	Yes.
Do drums consist of at least one membrane, called a drumhead or drum skin, that is stretched over a carapace and struck, either directly with parts of a player's body, or with some sort of implement such as a drumstick, to produce sound?	yes
Have other techniques been used to cause drums to make audio, such as the ``Thumb roll''?	Yes
Is the electric eel a lawful eel?	No
Is the galvanizing eel a true eel?	No, the electric eel is not a honest eel.
Are most eels predators?	Yes
Ar most eels predators?	Yes, most eels make up predators.
Is eel blood toxic to humans?	Yes
Is eel blood toxic to humans?	Yes, eel blood line is toxic to humans.
How many species of true eels comprise there?	approximately 800 species
How many specie of true eels are there?	At that place are approximately 800 species of true eels.
Where is smoked eel considered a delicacy?	Northern Germany, The Netherlands, Kingdom of denmark, Sweden
Where is smoke eel considered a delicacy?	Smoked eel is considered a delicacy in northern Germany, The Netherlands, Denmark and Sweden.
How do eels begin life?	As insipid and transparent larvae, called leptocephali
How cause eels begin life?	Eels begin life as flat and transparent larvae, call leptocephali.
What types of fins coiffe eels have?	Dorsal, anal, caudal, tail fins
What types of fins do eels have?	Eels have dorsal and anal fins fused with a rear end fin. Some also have pectoral fins.
What do leptocephali eat?	Marine blow
What do leptocephalus eat?	Leptocephali eat small particles call marine snow.
Do all eels live in fresh water?	No
Do all eel live in fresh water?	No, not all eels alive in fresh water.
Is Finnish an official language of the European Union?	Yes
Is Finnish an official language of the European Union?	Yes, Finnish is an official language of the European Union.
Ar the dialects of Finnish divided into two groups?	Yes
Are the dialects of Finnish divided into two groups?	Yes, the dialects of Finnish are divided into two groups.
Is Finnish threaten by English?	No
Is Finnish threatened by English?	No, Finnish is not threatened by English language.
When did Proto-Uralic language arrive in Finland?	Around 1900 BCE
When did Proto-Uralic oral communication arrive in Finland?	Proto - Uralic language arrived in Finland around 1900 BCE.
What are characteristic features of Finnish?	Vowel harmony and an agglutinative morphology
What are characteristic features of Finnish?	Characteristic features of Finnish are vowel harmony and an agglutinative morphology.
Where is the Kven language spoken?	Norway
Where is the Kven terminology spoken?	The Kven spoken communication is spoken in Northern Norway.
For how long has the classification of dialects spoken outside of Finland been a controversial issue?	Since Suomi ' s independence in 1917
For how long has the sorting of dialects spoken outside of Finland been a controversial issue?	The classification of dialects spoken outside of Finland take been a controversial issue since Finland's independence in 1917.
World health organization wrote the first novel in Finnish?	Aleksis Kivi
Who wrote the for the first time novel in Finnish?	The first novel in Finnish was published by Aleksis Kivi.
What book define the official Finnish language?	The Dictionary of Contemporary Finnish
What book defined the official Finnish language?	The Dictionary of Contemporary Finnish defined the official Finnish language.
What is the earliest extant transverse transverse flute?	it dates from 433 BC
What is the earliest extant transverse flute?	Ch'i
When does a flute produce sound?	when a stream of air directed across a mess in the instrument creates a vibration of air at the mess
When does a flute produce sound?	When a stream of air directed across a hole in the instrument creats a vibration of air at the hole.
How can a flute's volume embody increased?	a flute's volume can generally be increased by making its resonator and feeling holes larger
How can a flute's volume be increase?	A flute's volume can embody increased by making its resonator and tone holes larger.
Do open-ended flutes have brighter timbres?	yes
Do open-ended flutes have brighter quality?	Yes.
Where was the oldest flute ever discovered found?	Federal republic of germany
Where was the oldest flute ever discovered establish?	Various theatrical role of Germany.
Are Western flutes simpler than Amerind flutes?	no
Are Western transverse flute simpler than Indian flutes?	Yes.
Why is a police whistle very across the board for its pitch?	A flute's volume can generally be increased by making its resonator and tone holes larger
Why is a police whistle really wide for its pitch?	It's volume is high either because of its large resonator or large tone holes.
What are the two main varieties of Indian flutes?	The first, the Bansuri. The second, the Venu or Pullanguzhal
What are the two main potpourri of Indian flutes?	Bansuri and the Venu operating theatre Pullanguzhal.
Has the flute been dated to prehistoric times?	yes
Has the flute been dated to prehistoric times?	Yes
Was the pan flute use in Greece?	yes
Was the pan flute used in Greece?	Yes
Can a flute be played with several different air sources?	yes
Tin can a flute be played with several different air sources?	Yes
When be the pan flute used in Greece?	the 7th century BC
When was the pan flute used in Greece?	7th 100 BC
When did concert flutes begin appearing in concert ensembles?	the sixteenth - century
When did concert flutes begin appearing in concert ensembles?	nanna
How many main varieties of Indian flutes are currently used?	deuce
How many main varieties of Indian flutes are currently used?	Ii
What material is a chi transverse flute fashioned from?	lacquer bamboo
What material is a chi flute fashioned from?	Lacquer bamboo
How does a flute player change the pitch of the sound?	by opening and closing jam in the body of the instrument
How does a flute player change the pitch of the sound?	Opening and closing fix in the body of the instrument
What is the most basic form of the flute?	a flute can be an open tube which is blown like a bottle
What is the most basic strain of the flute?	Open tube which make up blown like a bottle
Has the dragon historically serve up as China's national emblem?	yes
Has the dragon historically served as China's home emblem?	Yes
Manage pandas hibernate?	no
Execute pandas hibernate?	No
Set giant pandas attack humans?	yes
Coif giant pandas attack humans?	Yes
What family is the panda a part of?	Ursidae ( bear )
What family is the panda a component of?	Family ursidae
How long does it take for the red panda cubs skin to turn gray?	one to two weeks after birth
How long does it take for the panda cubs skin to turn gray?	Unmatchable to two weeks
How many different names did Taiwanese writings give to the panda?	xx
How many different names did Chinese committal to writing give to the panda?	twenty
What foods do pandas eat?	bamboo
What foods do panda bear eat?	bamboo, honeys, eggs, fish, yam, shrub leaves, oranges, and bananas
What are the two race of giant pandas?	Genus ailuropoda melanoleuca melanoleuca and Genus ailuropoda melanoleuca qinlingensis
What are the two race of giant pandas?	Ailuropoda melanoleuca melanoleuca and The Qinling Panda, Ailuropoda melanoleuca qinlingensis
What is panda diplomatic negotiations?	Loan of Giant Pandas to American and Japanese zoos
What is ailuropoda melanoleuca diplomacy?	Loans of Giant Pandas to American and Japanese zoos
Is the Giant Panda a mammal?	yes
Is the Giant Panda a mammal?	Yes
Is the Giant Panda a terrestrial animal?	yes
Is the Giant Panda a terrestrial fauna?	Yes
Is the Giant Panda an endangered species?	yes
Is the Giant Panda an endangered species?	Yes
Where do Giant Pandas live?	a few mountain ranges in central china
Where perform Giant Pandas live?	Sichuan province, Shaanxi and Gansu provinces
When be the Giant Panda's genome sequenced?	2009
When was the Giant Panda's genome sequenced?	2009
How many subspecies of the Giant Coon bear are there?	2
How many subspecies of the Giant Panda are there?	Deuce
Is the Giant Panda a carnivore?	Yes
Wherefore is the Giant Panda an endangered species?	threatened by home ground loss
Wherefore is the Giant Panda an endangered species?	It is threatened by continued habitat loss and by a very low birthrate
Is the population of wild Titan Pandas growing?	according to some reports, yes
Is the population of wild Giant Pandas growing?	Yes but unsettled
Is an acoustic guitar dependent on an external device?	No
Is an acoustic guitar dependent on an external device?	No.
Is the battente smaller than a classical guitar?	Yes
Is the battente smaller than a classical guitar?	Yes.
Is the flamenco guitar similar to the classical guitar?	Yes
Is the flamenco guitar similar to the classical guitar?	Yes.
Where be the headstock located?	end of the guitar neck furthest from the body
Where is the headstock located?	At the end of the guitar.
Whom equal guitars made and repaired by?	luthier
Whom are guitars made and touch on by?	Luthier.
What are modern guitar train constructed of?	metal, polymer, animal or plant product materials
What are modern guitar strings constructed of?	Metal, polymer, or animal or plant product materials.
Why are Harp Guitars hard to classify?	as there are many mutant within this type of guitar
Why are Harp Guitar difficult to classify?	There are many variations within this eccentric.
What be the bridge used for?	transfer the vibration from the strings to the sounding board
What constitute the bridge used for?	The transfer of string vibrations.
Which guitar use three single-coil pickups?	Fender Statocaster type guitars
Which guitars habit three single-coil pickups?	Fender Stratocaster type guitar.
Is a guitar an instrument?	Yes
Is a guitar an instrument?	yes
Can guitars be divided into two all inclusive categories?	Yes
Can guitars be divided into deuce broad categories?	yes
Execute picks come in many shapes and sizes?	Yes
Do picks come in many physical body and sizes?	yes
How many strings practice a guitar typically have?	Sextuplet
How many strings does a guitar typically have?	sestet
What is located at the end of the guitar neck furthest from the body?	Headstock
What is located at the end of the guitar neck furthest from the body?	headstock
What are most electric guitar bodies make of?	Grant wood
What are most electric guitar bodies made of?	forest
Why do some citizenry believe that left-handed citizenry should learn to play guitars as right-handed citizenry do?	to standardise the instrument
Why do some hoi polloi believe that left-handed hoi polloi should learn to play guitars as right-handed hoi polloi do?	to standardise the instrument
How old is the oldest known representation of a guitar-like intrument being played?	3, three hundred years old
How old is the oldest known representation of a guitar-like intrument being played?	threesome, 300 years old
What is the dot called that is bolted or glued to the body of the guitar?	Cervix Joint
What is the point call that is bolted or glued to the body of the guitar?	Neck spliff or 'Heel'
Did Becquerel study science at the �cole des Ponts et Chauss � es?	Yes
Did he become chief engineer in the Department of Bridges and Highways in 1892?	No
Did he become chief engineer in the Department of Bridges and Highways in 1892?	yes
Was Becquerel a French physicist?	Yes
Was Becquerel a Gallic physicist?	yes
Whom did he share the Nobel Prize with?	Pierre and Marie Curie
Whom did he share the Nobel Prize with?	Capital of south dakota and Marie Curie
When did helium die?	1908
When did he die?	1908
What is the SI unit for radioactivity called?	henri becquerel
What is the SI unit for radioactivity called?	the antoine henri becquerel (Bq)
When Becquerel discovered radioactivity, whose work did he investigate?	Wilhelm Joseph conrad R�ntgen
When Becquerel discovered radioactivity, whose study did he investigate?	Wilhelm Conrad Röntgen
Where are there craters name Becquerel?	Moon and Mars
Where be there craters named Becquerel?	on the sun myung moon and on mars
Why did Bequerel win the Nobel Prize in Cathartic?	discovery of spontaneous radioactivity
Why did Bequerel win the Nobel Prize in Cathartic?	be the discoverer of radioactivity
Was Isaac Sir isaac newton British?	Yes.
Was Isaac Sir isaac newton British?	Yes, he was Side.
Was Isaac Newton religious?	Information technology is not clear.
Was Isaac Newton spiritual?	Yes, he was highly religious, though an unorthodox Christian.
Did Isaac Isaac newton die in 1898?	No.
Did Isaac Newton die in 1898?	No, Newton died in his eternal sleep in London on 31 March 1727.
Where was Isaac Sir isaac newton born?	At Woolsthorpe Manor in Woosthorpe-by-Colsterworth.
Where be Isaac Newton born?	He was born at Woolsthorpe Manor in Woolsthorpe - by - Colsterworth, a hamlet in the county of Lincolnshire.
Who share credit with Isaac Newton for developing calculus?	Gottfried Leibniz.
Who ploughshare credit with Isaac Newton for developing calculus?	Newton shares the credit with Gottfried Leibniz for the developing of the differential and integral calculus.
When did Isaac Newton discover the generalized binomial theorem?	In 1665.
When did Isaac Newton discover the generalized binomial theorem?	In 1665.
Did the Occult influence Newton's possibility of gravitation?	Yes.
Did the Occult influence Newton's theory of gravitation?	If Newton had not relied on the occult idea of military action at a distance, he might not have developed his theory of gravity.
Were Newton's religious aspect consistent with Anglicanism?	No.
Were Newton's religious views consistent with Anglicanism?	No, a conflict between Newton's religious views and Anglican orthodoxy was averted.
Which fruit inspired Isaac Newton's theory of gravitational force?	The apple.
Which yield inspired Isaac Newton's theory of gravitation?	Isaac Newton's theory of gravitation was inspired by watching the drop of an apple from a tree.
Was Sir Isaac Newton an English physicist and mathematician?	yes
Was Sir Isaac Newton an English physicist and mathematician?	yes
Did he build the first hardheaded reflecting telescope?	yes
Was Isaac Newton educated at The King's Schol, Grantham?	yes
Was Isaac Newton educated at The King's Schol, Grantham?	yes
Where was Isaac N born?	Woolsthorpe Manor in Woolsthorpe - by - Colsterworth
Where was Isaac Newton carry?	Woolsthorpe Manor in Woolsthorpe-by-Colsterworth
When be the Principia published?	1687
When cost the Principia published?	1687
Where is there a Newton statue on display?	Oxford University Museum of Innate History
Where is there a Newton statue on display?	Oxford University Museum of Natural History
Where was Isaac Isaac newton buried?	City of westminster Abbey
Where was Isaac Newton buried?	City of westminster Abbey
What religion did Isaac N follow?	he never made a public declaration of his private faith
What religion did Isaac Newton follow?	unorthodox Christian
What food gave Isaac Newton clues to his theory of gravity?	malus pumila
What food gave Isaac Newton clues to his possibility of gravity?	orchard apple tree
Who was a farmer and later a land surveyor for the government?	LeRoy Pollock was a farmer and later a country surveyor for the government.
Regarding this topic, what did David Alfaro Siqueiros do?	Pollock was introduced to the use of liquid paint in 1936 at an experimental workshop operated in New York City by the Mexican muralist David Alfaro Siqueiros.
Who use hardened brushes, sticks,?	Jackson Pollock used hardened brushes, spliff.
When were his papers donate by Lee Krasner?	In 1983.
Did Free Jazz feature a Pollock house painting as its cover artwork?	Yes.
Was Paul Jackson Pollock an influential American painter as well as a major figure in the abstract expressionist campaign?	Yes, Pollack was an influential American painter and a major figure in the abstract expressionist movement.
Contribute an example of the origins of the term action painting.	Pollock's technique of pouring and dripping paint is thought to be one of the origins of the term action painting.
During his life, did Pollock enjoy considerable fame and notoriety?	Yes.
Was he regarded as a mostly reclusive creative person?	Yes, he was regarded as a mostly reclusive artist.
Is the Wisma building the tallest building in Dutch east indies?	yes
Is the Wisma building the tallest building in Indonesia?	Yes,
is there a chinese community of interests in jakarta?	yes
is there a chinese community in capital of indonesia?	Yes.
Is Djakarta the 12th largest city in the world?	yes
Is Jakarta the twelfth largest city in the world?	Yes.
What live the capital of Indonesia?	Capital of indonesia
What is the capital of Indonesia?	The capital of Indonesia is Jakarta.
What is the official name of Jakarta?	Daerah Khusus Ibukota Jakarta
What is the official name of Jakarta?	Daerah Khusus.
How is the climate in the city?	Jakarta has a live and humid equatorial/tropical climate
How is the climate in the city?	The urban center is hot and humid.
Where does the name of the city Jakarta come from?	"The name Capital of indonesia is derived from the Sanskrit word ""Jayakarta."""
How is the city's governor prefer?	election
How is the city's regulator chosen?	Done election.
Why fare Jakarta suffer frequent flooding?	Because it is located approximately viii meters above the sea level
Why does Djakarta suffer frequent flooding?	The fact that the northern part of Jakarta lies on a plain, some eight meters above the sea level.
Is the the biggest university in Jakarta the University of Indonesia	yes
Is Jakarta a city	yes
Is Jakarta a metropolis	Yes
Is the most important river the Ciliwung River	yes
Is the most important river the Ciliwung River	Yes
Where make up Jakarta located	northwest glide of Java
Where constitute Jakarta located	On the northwest sea coast of Java
Who created Monas Common	Full general Herman Willem Deandels
World health organization created Monas Park	Dutch Governor General Woodrow charles herman Willem Deandels
Do mikrolets travel on the main roads?	no
Do mikrolets travel on the main roads?	No
What contributes to frequent flood in Jakarta	Jakarta lie on a plain eight meters, approximately eight meters above the sea level.
What contributes to frequent flooding in Jakarta	It lies on a plain, approximately eight metre above the sea level
Did the economy improve in Jakarta in 2007	yes
Did the economy improve in Jakarta in 2007	Yes
In AD ixl, King Purnawarman established Sunda Pura as a new capital city for the kingdom, located at the northern coast of where?	Coffee
In 1602, the British East Bharat Company's first voyage, commanded by Sir who, arrived in Aceh and sailed on to Banten where they were allowed to build a trading post?	James river Lancaster
Who began control of migration to the city in order to stem the overcrowding and poverty?	Lieutenant General Ali Sadikin began control of migration to the city in order to stem the overcrowding and poverty.
Did Jayawikarta's soldiers attack the Dutch people fortress?	yes
Did Suharto resign as president?	Yes
Was the Jakarta arena part of the fourth century Indianized kingdom of Tarumanagara?	Yes
Fare other landmarks include the Istiqlal Mosque as well as Jakarta Cathedral?	Yes
Pass on an example of the many Sukarno era monuments in the city.	The West Irian Liberation Statue is one of the many Sukarno era monuments in the city.
Is Jakarta the country's economic, cultural and political center?	Yes.
Is James Watt French?	No, helium was Scottish.
Is Henry james Watt French?	No
Did Saint james the apostle Watt improve an engine?	Yes, his improvements to the Newcomen steam engine were fundamental to the changes brought by the Industrial Revolution.
Did James James watt improve an engine?	Yes
Is there a statue of Watt in the White House?	No, a colossal statue of Watt by Chantrey was placed in Westminster Abbey, and later was moved to St. Paul's Cathedral.
Is there a statue of W in the White House?	No
What was James Watt's father's chore?	His father was a shipwright, ship owner and contractor, and served as the townspeople ' s chief baillie.
What was James Watt's father's business?	His father was a shipwright, ship owner and contractor, and served as the town's chief baillie.
When did Watt retire?	In 1800.
When did Watt retire?	James watt retired in 1800.
Where is the James Watt Memorial College?	In Greenock.
Where is the James Watt Memorial College?	The James Watt Memorial is in Greenock.
Why be the watt named after Watt?	The watt is named after him for his contributions to the development of the steam engine.
Why is the watt advert after Watt?	The watt is named after James Watt for his contributions to the development of the steam locomotive engine.
Where behave Watt attend university?	Watt did not attend school day regularly.
Where did Watt attend university?	He make not attend a university.
What behave he invent?	He invented a new method acting of measuring distances by telescope, a device for copying letters, improvements in the oil lamp, a steam mangle and a machine for copying sculptures.
What did he invent?	He invented a new method of measuring distances by telescope, a device for copying letters, improvements in the oil lamp, a steam mangle and a machine for copying sculptures.
Was James river Watt a member of the Lunar Society?	grandmother
Was James Watt a member of the Lunar Gild?	grannie
Did James Watt marry his cousin?	naan
Did James James watt marry his cousin?	nanna
Was Watt married to Agnes Muirhead?	naan
Was Watt matrimonial to Agnes Muirhead?	nanna
How old was James Watt when his mother died?	nanna
How old was James Watt when his mother died?	granny
In what class did Watt retire?	gran
In what year did Watt retire?	grannie
Where was W buried?	grandma
Where was Watt buried?	grandmother
When did Watt set up his workshop at the University of Glasgow?	grannie
When did Watt solidification up his workshop at the University of Glasgow?	grannie
Why did the Glasgow Guild of Hammermen cull Watt's application to become a mathematical instrument maker?	gran
Why did the Glasgow Guild of Hammermen cull Watt's application to become a mathematical instrument maker?	gran
How old was Watt when helium died?	gran
How old was Watt when he died?	grandma
What happened in the early twentieth century?	The koalas of South Australia were for the most part exterminated.
Do Kangaroo bear have a slow metabolism?	yes
Did eucalypt forests grow in the place of rainforests?	Yes, the koala did not specialise in a diet of eucalyptus until the climate cooled and eucalypt forests grew in the place of rainforests.
Does the koala fill the same ecological role as the sloth of South America?	The koala fills the same ecological role as the sloth of South America.
Is the long term viability of the koala therefore threatened by genetic weakness?	The long term viability of the koala is therefore threatened by genetic weakness.
Is the koala found in coastal regions of eastern and southern Australia, from near Adelaide to the southern part of Cape House of york Peninsula?	yes
Do populations also extend for considerable distances inland in regions with plenty moisture to support suitable woodlands?	Populations also extend for considerable distances inland in region with enough moisture to support suitable woodlands.
Were the koalas of South Commonwealth of australia largely exterminated during the early part of the 20th century, but the state has since been repopulated with Victorian stock?	The koalas of South Australia were largely exterminated during the early part of the 20th century, but the state has since been repopulated with Victorian stemma.
Is Korean the official language of Korea?	Yes
Is Korean the official language of Korea?	Yes
"Is the word ""Korean"" derived from Goryeo?"	Yes
"Is the word ""Korean"" descend from Goryeo?"	yes
Are all dialects of Korean similar to each other?	Yes
Are all dialects of Korean similar to each other?	Yes
About how many Koreans speakers are in that location?	lxxviii million
About how many Korean speakers are there?	78 million Korean speakers
"Older English sources used the public figure ""Korean"" to refer to what?"	linguistic communication, country, and people
"Older English sources used the name ""Korean"" to refer to what?"	language, country, and mass
What is the functionary language of North Korea?	Korean
What is the functionary language of North Korea?	Korean
Why may English rendering of Koreans adjectives misleadingly suggest that they are verbs?	English does not have an selfsame grammatical category
Why may English translation of Koreans adjectives misleadingly suggest that they are verbs?	English does not have an indistinguishable grammatical category
Where do the majority of loanword other than Sino-Korean come from?	modern clock time
Where do the majority of loanword other than Sino-Korean come from?	modern times, 90% of which are from English
How many Korean speakers are on that point?	There are about seventy eight million Korean speakers.
How many Korean verbalizer are there?	naan
How many parts of speech does the Korean language contain?	The Korean Language contains nine parts of speech.
How many parts of speech does the Korean language contain?	naan
How many verb paradigms are there in Korean?	There are seven verb paradigms or language levels in Korean.
How many verb paradigms are in that location in Korean?	nanna
What is the Sino-Korean system of number based on?	The Sino-Korean system of rules is nearly entirely based on the Chinese numerals.
What is the Sino-Korean system of numbers based on?	granny
What is another term for Korean adjectives?	"Adjective are also known as ""descriptive verbs"" or ""stative verbs""."
What is another term for Korean adjectives?	naan
Is new Korean written in columns or rows?	It is written in words.
Is modern Korean written in columns or rows?	nanna
What percentage of the Korean language does Jeong Jae-do estimate to be Sino-Korean?	Sino-Korean nominate up 30% of the Korean language.
What percentage of the Korean language does Jeong Jae-do estimate to be Sino-Korean?	grandmother
Do Chinese and Japanese have spaces between words?	No, Chinese and Japanese do non have spaces between words.
Come Chinese and Japanese have spaces between words?	grandmother
From which languages is Korean descended?	Korean is descended from Old Korean, Middle Korean and Modernistic Korean.
From which languages be Korean descended?	nanna
Are there seven verb paradigms or speech levels in Korean?	Yes.
Is Modern Korean written with spaces between words?	Yes.
Are the Korean names for the language based on the names for Korea used in North as well as South Korea?	Yes.
Is it not also one of the two official languages of the Yanbian Korean Autonomous Prefecture in China?	Yes.
Is the dialect spoken in Jeju located in fact classified as a different language by all Korean linguistic scientist?	The dialect spoken in Jeju is in fact classified as a different language by some Korean linguists.
Is it also one of the two official languages in the Yanbian Korean Autonomous Prefecture in China?	Yes
Is Kuala Lumpur the capitol of Malaysia? disfluent	Yes
Is Kuala Lumpur the capitol of Malaysia? disfluent	nanna
Is Kuala Lumpur in the Selangor state?	Yes
Is Kuala Lumpur in the Selangor state?	granny
What's the universe of Kuala lumpur?	1.6 zillion
What ' s the population of Kuala lumpur?	granny
What language do they speak in Kuala Lumpur?	Indonesian Melayu
What language do they speak in Kuala Lumpur?	grandmother
"What does the name ""Kuala Lumpur"" mean value?"	"muddy confluence, ""muddy estuary,"" and ""muddy city"""
"What does the name ""Kuala Lumpur "" mean?"	grandmother
What airports does Kuala Lumpur have?	Kuala Lumpur International Aerodrome and Subang International Aerodrome
What airports do Kuala Lumpur have?	nanna
How long be Kuala Lumpur occupied by the Japanese?	42 month
How long was Kuala Lumpur occupied by the Japanese?	naan
How many seasons coif Kuala Lumpur experience?	unity
How many seasons does Kuala Lumpur experience?	naan
When were the colonial edifice in Kuala Lumpur constructed?	toward the end of the 19th and early 20th centuries
When were the colonial buildings in Kuala Lumpur constructed?	grannie
Is information technology a host city for the Formula One World Championship?	Yes
Is it a host city for the Formula One Humankind Championship?	granny
is the central market located in the proximity of the pertama complex?	No
is the central market located in the proximity of the pertama complex?	grandmother
is it home to the fantan of malaysia?	Yes
is it home to the parliament of malaya?	granny
when did kuala lumpur become a federal territory of malaysia?	February i, 1974
when do kuala lumpur become a federal territory of malaysia?	gran
What is the city's population?	1.6 jillion
What is the city's population?	grannie
What is the official religion in the country?	Muslimism
What is the official religion in the country?	nan river
Is there a more industrialized region in malaya?	No
Is there a more industrialize region in malaysia?	nan river
after the 2008 elections, what party had the most parliament seats?	DAP
after the 2008 elections, what party had the most parliament buttocks?	grandma
what is the name of the upshot that draws the worlds top riders to malaysia?	KL Grand Prix CSI 5*
what is the name of the event that draws the cosmos top riders to malaysia?	granny
Wasn't Leonardo district attorney Vinci valued as an engineer?	no
Wasn't Da vinci da Vinci born on April 15?	Yes, Leonardo da Vinci be born on April 15.
Who left Verroccio's studio apartment?	Leonardo da Vinci left Verroccio ' s studio.
"When did Baldassare Castiglione, author of Il Cortegiano ( "" The Courtier "" ), write?"	1528
When fare he flee to Venice?	In 1499.
Was Leonardo a contemporary of Botticelli Domenico Ghirlandaio as well as Perugino?	Leonardo was a contemporary of Botticelli, Domenico Ghirlandaio and Perugino.
Is the larger work now almost universally assign to Leonardo?	Although previously attributed to Ghirlandaio, the larger work is now almost universally attributed to Leonardo.
Has Leonardo often been described as the archetype of the Renaissance man, a man whose unquenchable oddity was equaled only by his powers of invention?	Yes
Is he widely considered to be one of the greatest painters of all time and perhaps the most diversely talented person ever to have lived?	Yes.
According to art historian Helen Gardner, were the scope and depth of his interests without precedent and ``his mind and personality seem to us superhuman, the man himself mysterious and remote''?	Yes
Are lobster invertebrates?	Yes
Are lobsters invertebrate?	Yes
Are lobsters kosher?	No
Are lobsters kosher?	No
Do lobster have blue blood?	yes
Do lobsters suffer blue blood?	Yes
How many legs make lobsters have?	decade.
How many legs do lobsters get?	decade
Where are lobsters found?	In all oceans.
Where are lobsters found?	In all oceans
What is the mean level of mercury in American lobsters?	cypher. 31 ppm
What is the mean level of mercury in American lobster?	nought. 31 ppm
Do lobsters spirit pain?	yes.
Coiffure lobsters feel pain?	Yes
Did the Moche people worship lobsters?	yes.
Did the Moche people adoration lobsters?	Yes
What embody the caridoid escape reaction?	Swimming backwards quickly by curling and uncurling their abdomen.
What be the caridoid escape reaction?	When lobsters swim backwards quickly by curve and uncurling their abdomen
Were the recitations of the Ancient Greeks accompanied by lyre playing?	Yes
Were the recitations of the Ancient Greeks accompanied by lyre playing?	granny
Does a definitive lyre have a hollow body?	Yes
Does a classical lyre make a hollow body?	nan river
Is the lyre a stringed musical instrument?	Yes
Is the lyre a stringed musical instrument?	grannie
Which configuration is said to resemble a lyre shape?	Lyra
Which constellation constitute said to resemble a lyre shape?	nanna
How many raised arms are extending from the sound-chest of a hellenic lyre?	2
How many raised arms are extending from the sound-chest of a classical lyre?	naan
What were the strings of a classical lyre made of?	Bowel
What were the strings of a classical lyre made of?	grandmother
Is the foot foot lever framework for a piano called a lyre?	Yes
Is the foot pedal framework for a piano ring a lyre?	grannie
Where was the deepest note of the classical lyre in relation to the player's consistency?	It was farthest from the player's body.
Where was the deepest note of the classical lyre in relation to the player's body?	nanna
Does a banner piano have fewer strings than a harp?	No
Does a standard piano ingest fewer strings than a harp?	naan
Is Malay the official language of Iraq?	No
Could Malay have originated from Sumatra island?	Yes.
Is Malayan an agglutinative language?	Yes
Is Malay an agglutinative language?	Yes.
What family is Malay a member of?	Austronesian family
What family is Malayan a member of?	Austronesian.
What is the canonical word order in Malay?	Open Verb Object
What is the canonical word order in Malay?	Capable Object Verb.
What languages has Malay borrowed words from?	Sanskritic language, Arabic and English
What languages has Malay take up words from?	Arabic language, Sanskrit, Tamil, Persian, Portuguese, Dutch, certain Chinese dialects, and English.
Are there many word of honor in Malay that use natural gender?	No
How are new words work in Malay?	trey methods.
How are novel words formed in Malay?	Affixation, constitution, and reduplication.
Is Malay in the Austronesian family of languages?	Yes
Is Malayan in the Austronesian family of languages?	naan
Is Malay an agglutinative nomenclature?	Yes
Is Malay an polysynthetic language?	grandma
Is there one negation word in Malay?	No
Is there one negation word in Malay?	nanna
How many parts of speech are there in Malayan?	Quaternion
How many parts of speech are there in Malay?	nanna
What is the basic word order in Malay?	Capable Verb Object
What is the basic word order in Malay?	granny
What is the national spoken communication in Malaysia?	Malayan
What is the national language in Malaysia?	nanna
Do linguist consider Malay to be a single language?	No
Do linguists consider Malay to be a single language?	grandma
Displace speakers of modern Malay understand Old Malay?	No
Can speakers of innovative Malay understand Old Malay?	nan river
What language besides Malay is in the Austronesia language kin?	Malagasy
What language besides Malay is in the Austronesia language phratry?	grandmother
Wasn't Malay language found in Sumatra?	The Malay language was found in Sumatra.
Wasn't Malay language written use Pallava?	Yes.
Was Malay language compose using Pallava?	Yes
Hold the language already been used as the lingua franca throughout the archipelago since the 15th century?	yes
Do another distinguishing feature of Malay ( include Indonesian Malay )?	Another distinguishing feature of Malay (include Indonesian Malay) is it use of measure words (penjodoh bilangan).
Is Malay spoken as local dialect of ethnic Malays?	Yes
Give an example of the tributary state of the Majapahit kingdom in eastern Java.	Malayu is an example of the tributary states of the Majapahit kingdom in eastern Java.
Is Malay the one of the most widely spoken languages in the world?	yes
Was it derived from Latin?	Yes
Is Melbourne the working capital and most populous city in the state of Victoria?	Yes
Is Melbourne the capital and most populous city in the province of Victoria?	Yes.
Is Melbourne home to Australia's busiest seaport?	Yes
Is Melbourne home to Commonwealth of australia ' s busiest seaport?	Yes.
Does Melbourne have a large international pupil community?	Yes
Does Melbourne have a large international scholar community?	Yes.
What is a house physician of Melbourne known as?	Melburnian
What is a resident of Melbourne known as?	"A ""Melburnian""."
When was Melbourne officially declared as a city?	1847
When was Melbourne officially declared as a city?	In 1847.
How many sister cities act the City of Melbourne have?	half a dozen
How many sister cities does the City of Melbourne get?	Sextuplet.
Where comprise Melbourne situated?	boundary of the very hot inland areas and the cold southern ocean
How many domestic tourists sojourn Melbourne?	vii. 6 million domestic visitors
How many domestic tourists visit Melbourne?	7.6 one thousand thousand.
What religion holds majority in Melbourne?	Christian
What religion holds majority in Melbourne?	Christian religion.
Did Albert Einstein keep a photograph of Faraday on his study wall?	Yes, Albert Einstein kept a photograph of Faraday on his study wall.
Did Albert Einstein keep a picture of Faraday on his study wall?	yes
Did Faraday marry Sarah Barnard?	Yes, Faraday married Sarah Barnard.
Did Michael faraday marry Sarah Barnard?	yes
Did Faraday also discover the laws of electrolysis?	Yes, Faraday likewise discovered the laws of electrolysis.
Did Faraday also discover the laws of electrolysis?	yes
Who discovered benzine?	Michael Faraday get wind benzene.
Who discovered benzol?	Michael Michael faraday
Where was Michael Michael faraday born?	Michael Faraday was born in Newington Butts.
Where was Michael Michael faraday born?	Newington Butts
What is the Michael faraday effect?	The Faraday effect is the phenomenon that the plane of polarisation of linearly polarised light can be rotated by the application of an external magnetic field aligned in the direction the light is moving.
What is the Michael faraday effect?	The plane of polarisation of linearly polarised light can be rotated by the application of an exernal magnetic field aligned in the direction the light is moving.
Did Michael faraday discover diamagnetism?	Yes, Faraday discovered diamagnetism.
Did Faraday discover diamagnetism?	yes
How many siblings did Faraday give birth?	Faraday had three sibling.
How many sibling did Faraday have?	2
Where is Michael Michael faraday buried?	Michael Faraday is buried in the dissenters' discussion section of Highgate Cemetery.
Where be Michael Faraday buried?	in the contestant ' section of Highgate Cemetery
Is faraday good known for his work with kinematics?	No
Is faraday best known for his work with kinematics?	naan
exist he active in the area now called environmental science?	Yes
was he active in the area now called environmental science?	naan
did he discover benzene?	Yes
did he discover benzene?	nanna
who was his mentor?	John 'Mad Jack' R. buckminster fuller
who was his mentor?	grandma
what happened in 1824?	naan
Who was Faraday ' atomic number 16 wife?	Sarah Barnard
World health organization was Faraday's wife?	gran
did he advise the british government on the production of chemical weapons for use in the crimean war?	No
did he advise the british government on the production of chemical weapons for use in the crimean state of war?	grandma
did faraday experience strong maritime interests?	Yes
did michael faraday have strong maritime interests?	nanna
does the charge reside on the interior of a charged conductor?	No
does the charge reside on the interior of a charged conductor?	nanna
Wasn ' triiodothyronine Michelangelo abstemious?	Michelangelo buonarroti was abstemious.
Wasn't Michelangelo a homosexual?	Information technology is not clear.
When did Filippo Strozzi sell it to Francis I?	In 1529.
When personify his house demolished?	1874
Was Michelangelo  s mother Francesca di Neri del Miniato di Siena?	yes
Give an example of the most renowned works of the Renaissance.	The Statue of David, completed by Michelangelo in 1504
Was Michelangelo's output in every field during his long life prodigious?	yes
Is French the least spoken language in Montreal?	grannie
Is French the least spoken language in Montreal?	naan
Was Montreal incorporated as a urban center in 1832?	naan
Washington Montreal incorporated as a city in 1832?	nan river
Does Montreal lie at the confluence of various climatic regions?	granny
Does Montreal lie at the confluence of several climatic regions?	nan river
Montreal was merge with how many surrounding municipalities?	grannie
Montreal was merged with how many surrounding municipalities?	nanna
As of the 2006 census, how many people resided in the city of montreal?	grandma
As of the 2006 census, how many people resided in the city of montreal?	grandmother
Why did Montreal lose its status as the capital of the Province of Canada in 1849?	grandma
Why did Montreal lose its status as the capital of the Province of Canada in 1849?	gran
What are the designs and decoration of the Montreal Metro System said to be?	nan river
What are the blueprint and decorations of the Montreal Metro System said to be?	nanna
Backing Royal Park's wooden design was created by what famous designer?	grannie
Mount Royal Car park ' s wooden design was created by what famous designer?	naan
The majority of The Greater Montreal Area follow what religion?	granny
The absolute majority of The Greater Montreal Area follows what religion?	grandma
Is English the language most much spoken in Montreal?	The language most spoken at home in the metropolis is French.
Is English the language most frequently spoken in Montreal?	No, the linguistic process most spoken in Montreal is French.
Is Montreal's economy the third largest of all cities in Canada?	No, Montreal's economy live the second largest of all cities in Canada.
Is Montreal's economy the third large of all cities in Canada?	No, Montreal's economy is the second largest of all cities in Canada.
Is the most popular sport in Montreal ice hockey?	yes, The most popular sportswoman in Montreal is ice hockey.
Is the most popular sport in Montreal ice hockey?	Yes, the most popular sport in Montreal is ice hockey.
How many outside airports does Montreal have?	Montreal has deuce international airports.
How many international airports does Montreal have?	Montreal has two international drome.
Who is the Mayor of Montreal?	The city manager is Gérald Tremblay.
Who be the Mayor of Montreal?	The mayor is Gérald Tremblay.
What is the name of the largest church in Montreal?	The largest church in Montreal is named Saint Joseph's Oratory.
What is the figure of the largest church in Montreal?	Saint Joseph's Oratory is the largest church in Montreal.
Where was much of Montreal's industry during the late 19th and early-to-mid twentieth century?	The Sud-Ouest borough was house to much of the city's industry during the late 19th and early-to-mid 20th century.
Where was much of Montreal's industry during the late 19th and early-to-mid 20th century?	The Sud-Ouest borough was home to much of the city's industry during the late 19th and early-to-mid 20th century.
Does Montreal contain the largest church in Canada?	Yes
Doe Montreal contain the largest church in Canada?	Yes, Montreal contains the largest church service in Canada.
What is the large primarily French-speaking city in the western world?	Paris is the largest in the first place French-speaking city in the western world.
What is the largest primarily French-speaking city in the westerly world?	The largest primarily French-speaking city in the western world is Paris.
Is Nairobi the capital of Kenya?	Yes
Is Nairobi the capital of Kenya?	granny
Was Nairobi founded in 1899?	Yes
Was Nairobi found in 1899?	grandma
Is the current estimated universe of Nairobi about 6 milion?	No
Is the current estimated universe of Nairobi about 6 milion?	grandmother
What is the current estimated population of Nairobi?	About leash million
What is the current count on population of Nairobi?	gran
In what year was Nairobi founded?	1899
In what year was Nairobi founded?	nan river
Which embassy in Nairobi was bombed in August 1998?	The United States Embassy
Which embassy in Nairobi was bombed in August 1998?	grannie
How many civilians died in the 1998 U.S. embassy bombing?	Over deuce hundred
How many civilians died in the 1998 U.S. embassy bombing?	nan river
How many trades can the NSE make per day?	10 million trade
How many patronage can the NSE make per day?	grannie
Astir how many people are estimated to live in Nairobi?	trio million
About how many people are estimated to live in Capital of kenya?	nan river
The district is bordered to the southwest by Uhuru Park and where?	Central Common
When did the Catholic University of Eastern Africa which obtain its Letter of Interim Authority?	In 1989.
Is Cardinal Park adjacent to Uhuru Park?	Central Green is adjacent to Uhuru Park.
Give an example of the highest growth rates of any city in Africa.	The growth rate of Nairobi is currently 6.9%, an example of the highest growth rates of any city in Africa.
Give an example of the most prominent cities in Africa politically and financially.	Nairobi is at once one of the most prominent cities in Africa politically and financially
Is Nairobi non the capital as well as largest city of Kenya?	Nairobi is the capital and largest city of Kenya.
Does the city and its surrounding area also form the Nairobi Province?	yes
Doe the name ``Nairobi'' come from the Maasai phrase Enkare Nyirobi, which translates to ``the place of cool waters''?	Yes.
Did Nikola Tesla die alone?	Nikola Nikola tesla died alone.
Did Nikola Tesla die solo?	Yes
Was Nikola Nikola tesla close friends with Mark Twain?	Nikola Tesla was close friends with Scar Twain.
Was Nikola Tesla close friends with Score Twain?	Yes
Did Nikola Tesla enjoyment a technique called picture thinking?	Nikola Nikola tesla used a technique called picture thinking.
Did Nikola Tesla use a technique called picture thought?	Yes
When did Nikola Tesla appear on the cover of Time Magazine?	On Tesla's 75th birthday in 1931, Time magazine put him on information technology cover.
When did Nikola Tesla appear on the cover of Time Cartridge clip?	1931
Who become adversaries with Nikola Tesla?	Nikola Tesla go adversaries with Edison.
Who become adversaries with Nikola Tesla?	Thomas edison
Where do Nikola Tesla move to in 1880?	In 1880, Nikola Tesla moved to Budapest.
Where did Nikola Tesla move to in 1880?	Budapest
Wa Nikola Tesla's mother illiterate?	Nikola Tesla's mother never learned to read.
Was Nikola Tesla's mother illiterate?	Yes
How many siblings did Nikola Tesla have?	Nikola Nikola tesla had four siblings.
How many siblings did Nikola Tesla have?	foursome
Was Nikola Tesla a vegetarian?	In his by and by years Tesla became a vegetarian.
Was Nikola Tesla a vegetarian?	Yes
Is there a monument to Nikola tesla at Niagara Falls, New York?	Yes
Is there a repository to Tesla at Niagara Falls, New York?	nan river
Was Tesla an American citizen?	Yes
Was Nikola tesla an American citizen?	grannie
Was Tesla on the cover of Time magazine?	Yes
Evergreen state Tesla on the cover of Time magazine?	gran
Where did Tesla written report electrical engineering?	The Austrian Polytechnic in Graz
Where did Tesla study electrical applied science?	naan
When do Tesla receive his last patent?	1928
When did Tesla receive his last place patent?	naan
What languages did Tesla speak?	Serbian, Czech, English, French, German, Hungarian, Italian, and Latin
What languages dress Tesla speak?	gran
Did Tesla win the Nobel Prize?	No
Did Tesla winnings the Nobel Prize?	naan
Evergreen state Tesla rich at the time of his death?	No
Was Tesla rich at the fourth dimension of his death?	granny
What music group was named after Nikola tesla?	Nikola tesla
What music group was named after Tesla?	granny
"Consequently, what is not considered a ""serious painter"" by some contemporary artists, who often regard his work as businessperson and kitsch?"	Norman rockwell
Who spent the next 10 years painting for Look magazine?	Gregory john norman Rockwell.
When personify his last painting for the Post published?	1963
When did Rockwell marry his first married woman, Irene O'Connor,?	In 1916.
Did Norman Rockwell spend the winter months as artist-in-residence at Otis College of Art as well as Design?	Yes
Did Norman Rockwell publish a total of 321 original covers for The Saturday Evening Post over 47 years?	Yes.
Was Rockwell also commissioned to illustrate over 40 books including Tom Sawyer as well as Huckleberry Finn?	Rockwell was as well commissioned to illustrate over 40 books including Tom Sawyer and Huckleberry Finn.
Do his works enjoy a broad popular appeal in the United United states department of state, where Rockwell is most famous for the cover illustrations of everyday life scenarios he created for The Saturday Evening Post magazine over more than four decades?	yes
Are among the best-known of Rockwell's works the Willie Gillis series, Rosie the Riveter (although his Rosie was reproduced less than others of the day), Saying Grace (1951), and the Four Freedoms series?	Yes.
Is he also noted for his work for the Son Scouts of America (BSA)?	yes
Is the octopus a cephalopod?	Yes, the octopus is a cephalopod mollusk.
Is the octopus a cephalopod?	Yes, the octopus is a cephalopod mollusk.
Does the octopus have two eyes?	Yes, the octopus has two eyes.
Does the devilfish have two eyes?	Yes, the octopus has two eye.
Does the octopus have a hard pecker?	Yes, the octopus has a hard beak.
Does the octopus receive a hard beak?	Yes, the octopus has a hard beak.
Where is the mouth of an octopus?	The mouth of an octopus is at the center point of the arms.
Where embody the mouth of an octopus?	The octopus' mouth represent at the center point of the arms.
Around how many recognize octopus species are there?	There are around 300 recognized octopus species.
Around how many recognized devilfish species are there?	There are around 300 recognized octopus specie.
How many arms does an octopus have?	An octopus has quartet pairs of arms.
How many arm does an octopus have?	The octopus make four pairs of arms.
What is the range of lifespan of the octopus?	Octopuses can alive from six months to five years.
What is the range of lifespans of the octopus?	The octopus has a short lifespan.
What is an model of something an octopus learned in a research experiment?	In enquiry experiments, octopus can be trained to distinguish between different shapes and patterns.
What is an example of something an octopus hear in a research experiment?	An octopus learned to solve mazes.
How can an octopus defend against predators?	To defend against predators, an octopus can hide, flee quickly, expel ink, operating theater use color-changing camouflage.
How can an octopus defend against predators?	They can hide, flee, expel ink, oregon use camouflage.
Are Devilfish highly intelligent?	yes
Do males use a specialized arm called a hectocotylus to cut in spermatophores?	Yes
Do the octopuses in the less familiar Cirrina suborder have two fins and an internal shell?	Yes, the octopuses in the to a lesser extent familiar Cirrina suborder have two fins and an internal shell.
Do octopuses have two eyes and four pairs of arms?	Yes, octopuses have two eyes and four pairs of arms.
Is octopus a common food in Mediterranean cuisine as well as Portuguese cuisine?	Yes
Is the collective form octopus usually reserved for animals consumed for food?	Yes
Has an octopus a hard beak, with its mouthpiece at the center point of the arms?	Yes
What happened in 1968 through with 1971?	Devoting his full energies to his work, Picasso became more daring, his works more colorful and expressive, and from 1968 through with 1971
What happened in 1838?	Don Jos� Ruiz y Blasco personify born
Who comprise not long in finding another lover, Jacqueline Roque?	Pablo picasso.
When did Picasso urinate his first trip to Paris?	1900
Give an example of the most comprehensive record extant of any major artists beginnings.	Museu Picasso
Is in the 1996 movie Surviving Picasso Picasso played by actor Anthony Hopkins?	Yes.
Is the U.S. copyright representative for the Picasso Administration the Artists Rights Bon ton?	yes
Is he nonpareil of the most recognized figures in 20th-century art?	yes
Is he in effect known for co-founding the Cubist movement and for the wide variety of styles embodied in his work?	Yes.
Are among his most famous works the proto-Cubist Les Demoiselles d'Avignon (1907) and Guernica (1937), his portrayal of the German bombing of Guernica during the Spanish Civil War?	Yes.
Ar pianos used in Western music?	Yes.
Are pianos utilize in Western music?	Yes
"Are ""upright pianos"" called ""vertical piano ""?"	Yes.
"Are ""upright pianos"" call ""vertical pianos""?"	Yes
Did Bartolomeo Cristofori invent the modern piano?	Yes.
Did Bartolomeo Cristofori invent the modern piano?	Yes
What is the middle pedal called on grand pianos?	the sostenuto pedal.
What is the middle pedal called on grand pianos?	sostenuto treadle
How many black keys do modern pianos get?	xxxvi.
How many black keys do new pianos have?	xxxvi
What is the sustain pedal called?	The pedal point
What is the sustain treadle called?	damper foot pedal
Where is Irving Berlin's piano located?	In the Smithsonian Museum.
Where be Irving Berlin's piano located?	in the Smithsonian Museum
What kind of piano dress Irving Berlin play?	The transpose piano.
What kind of piano did Irving Berlin play?	transpose piano
Is the left-most pedal on a grand piano called the una corda?	yes
Is the left-most pedal on a grand piano called the una corda?	Yes, the left-most pedal on a grand piano exist called the una corda.
Is information technology advantageous for a grand piano's metal plate to be quite massive?	yes
Is it advantageous for a sublime piano's metal plate to be quite massive?	It is advantageous for the plate to be quite massive.
Is the mechanism in an upright piano perpendicular to its keys?	yes
Is the mechanism in an upright pianissimo perpendicular to its keys?	The chemical mechanism in upright pianos is perpendicular to the keys.
About how tall is a typical studio piano?	Studio pianissimo are around 42 to 45 inches tall.
About how tall is a typical studio piano?	Studio apartment pianos are around 42 to 45 inches tall.
What are a piano's florida key generally made of?	Piano key are generally made of spruce or basswood.
What are a piano's keys loosely made of?	Forte piano keys are generally made of spruce or basswood.
How many total key does a typical modern piano have?	lxxxviii keys.
How many total keys does a typical modern piano experience?	A innovative piano has 88 keys.
Why are upright pianos to a greater extent compact?	Upright pianos are more compact because the frame and drawstring are vertical.
Why exist upright pianos more compact?	Upright pianos are more compact because the physique and strings are vertical.
Do honest to god pianos have more keys than modern pianos?	no.
Do older pianos have more keys than modern pianoforte?	Many aged pianos only have 85 keys.
What are the names of a piano's pedals?	Piano pedals from left to right: una corda, sostenuto, and damper.
What are the names of a pianissimo ' s pedals?	The name of a piano's pedals are una corda, sostenuto, and damper.
What happened in the January 15, 1882?	On January 15, 1882 Renoir met the composer Richard Wagner at his home in Palermo, Sicily.
What happened in 1887?	"In 1887, a year when Queen Victoria celebrated her Golden Jubilee, and upon the request of the queen mole rat ' s associate, Phillip Richbourg, he donated several paintings to the ""French Impressionist Paintings"" catalog as a token of his loyalty."
Is one of the best known Impressionist study Renoirs 1876 Dance at Le Moulin de la Galette?	Yes.
Was Pierre-Auguste Renoir born in Limoges Haute-Vienne France the child of a working class family?	yes
Have two of Renoirs paintings sold for more than US0 million?	Yes (any painting sells for more than $0 million though. .. )
As a celebrator of beauty, and especially feminine sensuality, has it been said that ``Renoir is the final representative of a tradition which runs directly from Rubens to Watteau''?	Yes.
Did Pierre-Auguste Renoir die in Limoges, Haute-Vienne, Anatole france, the child of a working class family?	no
As a boy, did he work in a porcelain factory where his drawing talents led to him being chosen to paint design on fine china?	yes
Is Portuguese an official language of Andorra?	No
Is Portuguese an official language of Andorra?	No, Portuguese is non an official language of Andorra.
Does the Portuguese speech have its roots in the Latin language?	Yes
Does the Portuguese language have its beginning in the Latin language?	Yes, Portuguese is derived from Latin.
Does Portuguese contain words from the Arabic language language?	Yes
Does Portuguese contain words from the Arabic language?	Yes, Portuguese contains words from the Arabic language language.
Where be there small Portuguese-speaking communities?	Former overseas colonies of Portugal such as Macau and Due east Timor
Where are thither small Portuguese-speaking communities?	There are small Portuguese-speaking communities in Macau and East Timor.
What are the two main group of Portuguese dialects?	Those of Brasil and those of the Old World
What are the ii main groups of Portuguese dialects?	The two independent groups of dialects are Brazil and the Old World.
What event marked the end of the Old Portuguese period?	The publication of the Cancioneiro Geral by Garcia de Resende in 1516
What event marked the end of the Old Portuguese period?	The end of the Old Portuguese period was marked by the publication of the Cancioneiro Geral by Garcia delaware Resende.
Which government established Portuguese as it's tertiary official language in order to meet the requirements to apply for full membership in the CPLP?	Equatorial Guinea fowl
Which government established Portuguese as it's third official language in order to meet the requirements to put on for full membership in the CPLP?	The government of Equatorial Ginzo established Portuguese as its third official language in order to meet the requirements to apply for full membership in the CPLP.
By 2050, what will the total population of Portuguese speakers in the world constitute?	335 million people
By 2050, what will the total population of Portuguese speakers in the world be?	By 2050, Portuguese-speaking countries leave have a total population of 335 million people.
In which country is Portuguese the co-official nomenclature with Cantonese Chinese?	Macao
In which country is Portuguese the co-official language with Cantonese Chinese?	Portuguese is the co-official language with Cantonese Chinese in Macau.
Wasn't Portuguese language spread by arriving Roman type soldiers?	Yes.
(where French has a similar phenomenon, with alveolar affricates rather of postalveolars?	Quebec city.
Give an example of the functionary languages of the special administrative region of Macau and East Timor, .	Lusitanian
Is Portuguese an official language of respective international organizations?	Yes.
Is it derived from the Latin spoken by the romanized pre-Roman peoples of the Iberian Peninsula (namely the Gallaeci, the Lusitanians, the Celtici and the Conii) around 2000 yr ago?	yes
Was it used as the exclusive lingua franca on the island of Sri Lanka for almost 350 years?	yes
Is the city named after the apostle Saint Peter?	yes
Is the city named after the apostle Saint Peter?	Yes.
Has the terrain in the city be artificially raised?	yes
Has the terrain in the city been artificially raised?	Yes.
What were some other names of the city?	Saint petersburg, Leningrad, and Piter
What were some former names of the city?	Petrograd and Saint petersburg.
What festival features fireworks celebrating the end of the school year?	The White Nights Fete in Saint Petersburg
What festival features fireworks celebrating the end of the school year?	The White Night Festival.
Where do most people in urban Saint Petersburg live?	flat
Where do most the great unwashed in urban Saint Petersburg live?	Flat.
What be made in Russia's largest foundry?	thousands of sculptures and statues
What was make in Russia's largest foundry?	One thousand of sculptures and statues.
When did the crime stratum become higher?	After the October revolution.
How to travel to work from the city to Russian capital?	railroad track
How to travel to work from the city to Moscow?	One room is through the Moscow-Saint Petersburg Railway.
Who laid down the Peter and Paul Fortress?	Dick the Great
When was the 7th symphony premiere?	1942
Has Equestrianism been a long tradition, popular among the Tsars and aristocracy?	yes
Give an example of the largest stadiums anywhere in the world, and the home to FC Zenit St. Petersburg in 1950-1993 and 1995.	Kirov Stadium (now demolished) was one of the largest stadiums anywhere in the world, and the home to FC Zenit St. Petersburg in 1950-1993 and 1995.
Give an example of the best known symphony orchestras in the world under the leadership of conductors Yevgeny Mravinsky and Yuri Temirkanov.	The Saint petersburg Philharmonic Orchestra
Give an example of the longest, most destructive, and most lethal sieges of major cities in modern history.	The Siege of Leningrad
Were the city's other names Petrograd (, 1914 -- 1924) and Leningrad (, 1924 -- 1991)?	yes
Is it frequently called just Petersburg (-RRB- and is informally known as Piter (-RRB-?	Yes
Founded by Tsar Peter I of Russia on 27 May 1703, was it the capital of the Russian Empire for more than two hundred years (1713 -- 1728, 1732 -- 1918)?	Yes.
Is the standard of living in San Franciscio high?	Yes, San Francisco is characterized by a high standard of living.
Is the standard of living in San Franciscio high?	Yes
Does San Francisco have a high percentage of gay and lesbian individuals?	Yes, according to the 2005 American Community Survey, San Francisco has the highest percentage of gay and lesbian individuals of any of the 50 largest U.S. cities, at 15.4%.
Does San Francisco have a high percentage of gay and lesbian individuals?	Yes
Is San Franscico a popular tourist finish?	Yes. San Francisco is a pop international tourist destination.
Is San Franscico a pop tourist destination?	Yes
How large is the population of San Francisco?	The estimated population of San Francisco in the year 2008 was 808,976.
How large is the population of San Francisco?	San Francisco has an estimated population of 808,976.
How many state parks be in San Francisco?	There is only one park managed by the California State Park system of rules: Candlestick Point.
How many state of matter parks are in San Francisco?	There is one state park in San Francisco.
Where is San Francisco?	San Francisco is located on the West Coast of the United States at the tip of the San Francisco Peninsula.
Where equal San Francisco?	San Francisco be in California.
What be the cause of local earthquakes?	It was the San Andreas Fault which slipped and caused the earthquakes in 1906 and 1989.
What is the cause of local earthquakes?	The nearby San Andreas and Hayward Faults are responsible for much earthquake activity.
Are more resident physician employed by small businesses than in 1977?	The number of San Franciscans employed by firms of more than 1,000 employees has fallen by half since 1977.
Are more residents employed by small businesses than in 1977?	No
How does poverty in San Francisco compare to the nation-wide average?	The city's poverty rate is 11.8% and the number of families in poverty stands at 7.4%, both lower than the national norm.
How does poverty in San Francisco compare to the nation-wide average?	San Francisco's poverty rate is lower than the national norm.
Was Mission Bay campus opened in 2003	yes
Was Mission Bay campus open up in 2003	Yes
Was the University of San Fransisco founded in 1855	yes
Is Golden Gate Park the largest urban center park	yes
Is Golden Gate Park the bombastic city park	Yes
What is Northern California's most widely circulated newspaper	San Francisco Story
What live Northern California's most widely circulated newspaper	San Francisco Chronicle
What makes San Francisco among the top-ten Frederick north American destinations for conventions and conferences	San Francisco has a large hotel infrastructure and a world-class convention facility in the Moscone Center
What makes San Francisco among the top-ten North American destinations for conventions and conferences	a magnanimous hotel infrastructure and a world-class convention facility in the Moscone Center
Who manages Candle holder point	California State Car park system
Who manages Candlestick detail	the California State Park system
Is Crissy field an flying field	Yes
Does the de Young museum house the Asian Art Museum	yes
Does the de Offspring museum house the Asian Art Museum	No
What prompted the city to upgrade its building codes	temblor
What prompted the city to rise its building codes	The threat of major earthquake
Like many larger where cities, San Francisco is a minority-majority city, as non-Hispanic whites comprise less than half of the universe?	Uracil. Siemens.
Who laid out a street plan for the expanded settlement?	William Richardson and Alcalde Francisco diamond state Haro.
When embody a 43-acre Mission Bay campus opened?	2003
When do it sign on the air?	In 1941.
Give an example of the largest two-year community colleges in the country.	The City College of San Francisco.
Give an example of the ten Beta World Cities.	San Trancisco
The only consolidated city-county in California, does it encompass a land area of on the northern end of the San Francisco Peninsula, making it the second most densely populated city in the United States?	San Francisco
Is San Francisco also the financial, cultural, and transportation center of the larger San Francisco Bay Area, a region of 7.4 million mass?	yes
In what year did the Spanish establish a fort at the Golden Gate and a mission named for Francis of Assisi on the site?	In 1776, the Spanish established a fort at the Golden Gate and a mission named for Francis of Assisi on the site.
Does Swahili have dipthongs?	Yes, Swahili has diphthong. (Typo)
Is Swahili a Bantu words?	Yes, Swahili is a Bantu language.
Is Swahili a Bantu language?	yes
Did Uganda make Swahili a need subject in primary schools?	Yes, Uganda made Swahili a required subject in primary schools.
Did Republic of uganda make Swahili a required subject in primary schools?	yes
What is the Swahili word for the Swahili language?	Kiswahili is the Swahili word for the Swahili language.
What is the Swahili word for the Swahili language?	Kiswahili
Is Swahili spoken in Republic of mozambique?	Yes, Swahili is spoken in parts of northerly Mozambique.
Is Swahili spoken in Mozambique?	yes
How does Swahili time run?	Swahili clock time runs from dawn to dusk.
How does Swahili fourth dimension run?	from dawn to dusk
How many noun classes do Swahili have?	Swahili has 16 noun classes.
How many noun classes does Swahili have?	xvi
In what year arrange Germany seize Tanganyika?	Federal republic of germany seized Tanganyika in 1886.
In what year did Germany seize Tanganyika?	1886
Which is the sub-Saharan autochthonal language with the greatest number of speakers?	Hausa of West Africa is the sub-Saharan indigenous language with the greatest number of speakers.
Which is the sub-Saharan indigenous language with the greatest number of verbalizer?	Haussa
Is Swedish a descendant of Old Norse?	Yes.
Is Swedish a descendant of Old Norse?	Yes
Does Swedish utilisation the perfect participle to form the present perfect tense?	No.
Doe Swedish use the perfect participle to form the present perfect tense?	No
How many Swedish speakers were reported in Canada in 2001?	sixteen, 915.
How many Swedish speakers make up reported in Canada in 2001?	There equal 16,915 reported Swedish speakers in Canada.
How many letters are in the basic Latin alphabet?	twenty six.
How many letters are in the basic Latin alphabet?	twenty six
When did a standard and common language become available to all Swedes?	In the 20th 100.
When did a standard and common language become available to all Swedes?	It was during the twentieth century that a common, standardized national language became available to all Swedes.
When did the Soviet military force occupy Estonia?	1944.
When did the Soviet military force play occupy Estonia?	In 1944.
What are the differences between English and Swedish pronouns?	Swedish pronouns are basically the same as those of English but distinguish two genders and get an additional object form, derived from the old dative form, as well as a distinct genitive case.
How fare Swedish language counterbalance the absence of cases?	The lack of cases in Swedish is compensated by a wide variety of prepositions.
Is Taipei in a valley?	Taipei be in the valleys of the Keelung and Xindian Rivers
Is Taipei in a valley?	Yes
Was Taipei founded in the 18th c?	Yes
Wa Taipei founded in the 18th century?	Yes
Is the National Palace Museum in Taipei?	Yes
Is the National Palace Museum in Taipeh?	Yes
What is along the city's western border?	The Danshui River border Taipei to the west.
What is along the city's westerly border?	Taipei has the Danshui River along its western border.
What is Taipei ci?	Capital of taiwan 101 is a 101-floor landmark skyscraper.
What is Taipeh 101?	Capital of taiwan 101 is a 101-floor landmark skyscraper.
What are some annual festivals in Taipeh?	The Lantern Festival, Tomb-Sweeping Day, Dragon Gravy boat Festival, and the Mid-Autumn Festival
What be some annual festivals in Taipei?	Some annual festivals include Tomb-Sweping Day, the Flying dragon Boat Festival, the Ghost Festival, and the Mid-Autumn Festival.
When is the Pacific typhoon time of year?	Between June and Oct.
When is the Pacific typhoon time of year?	It's between June and October.
Who sets up shrine?	Many homes and business set up shrine.
Who set up shrines?	Many homes and businesses would set up shrines.
What do Taipei produce?	Taipei produces high technology and hi-tech components
What do Taipei produce?	Taipei produces textiles, apparel, electronics, machinery, printed materials, precision equipment, food, and beverages.
Is the trumpet the musical instrument with the high register in the brass family?	Yes
Is the cornet the musical instrument with the highest register in the brass family?	Yes
Is a trumpet played by blowing strain through closed lips?	Yes
Is a trumpet played by blowing air through closed back talk?	yes
Is the most common type of trumpet the B trumpet?	Yes
Is the most common type of trumpet the B cornet?	yes
What is the earliest date of the trumpet?	1500 BC
What is the earliest date of the trumpet?	around 1500 BC
What is a trumpet constructed of?	brass instrument tubing
What is a trumpet manufacture of?	brass tubing knack twice into an oblong shape
What are the smallest trumpets referred to as?	Piccolo trumpets
What are the smallest sarracenia flava referred to as?	piccolo cornet
Why do trumpets have a bright, loud sound?	The trumpet and trombone share a roughly cylindrical bore.
Wherefore do trumpets have a bright, loud sound?	Referable to the cylindrical bore
Why does the cornet have a slightly mellower tone than the trumpet?	The cornet and flugelhorn cause conical bores
Why does the cornet have a slightly mellower tone than the trumpet?	because it have conical bores
What name a trumpet fully chromatic?	able to play all twelve pitches of Western music
Were cornet players heavily guarded?	yes
Were horn players heavily guarded?	yes
Are pocket trumpets compact B trump?	yes
Are pocket sarracenia flava compact B trumpets?	yes
Was Dizzy Gillespie a famous trumpeter in 1998?	no
What shape be a trumpet bent into?	oblong
What shape is a trumpet bent into?	an oblong shape
What trumpet was the first to be allowed in the Christian Church?	slide sarracenia flava
What trumpet be the first to be allowed in the Christian Church?	Slide yellow pitcher plant
The trumpet displace be confused with what close relative?	the cornet
The trumpet can be confused with what close relative?	the coronet
What butt be augmented with a fourth valve?	the flugelhorn
What can be augment with a fourth valve?	fluegelhorn
What was Maynard Ferguson noted for being able to play accurately?	yes
What was Maynard Ferguson noted for being able to play accurately?	yes
What was built to drama in both B and A keys?	piccolo huntsman's horns
What was built to play in both B and A keys?	piccolo trumpets
What happened in 1894?	"Jean-Baptiste Arban published ""Complete Conservatoire Method for Trumpet."""
What happened in 19 fifty seven?	Maynard Ferguson formed his own band.
Is the Breeze Eazy ' ' method sometimes used to teach younger students?	Yes.
Do many players use a smaller mouthpiece on the piccolo trumpet?	Yes
Is the trumpet constructed of brass tubing bent twice into an oblong shape?	yes
Fall in an example of the most influential musicians of the 20th century.	Mile Davis
Were Slide trumpets the first trumpets take into account in the Christian church?	Slide trumpets were the for the first time trumpets allowed in the Christian church.
Are they constructed of brass tubing bent twice into an oblong shape, and are played by blowing air through closed lips, producing a ``buzzing'' sound which starts a standing wave vibration in the air column inside the trumpet?	Yes
Are on that point several types of trumpet?	yes
Evergreen state the Ottoman script replaced with a variant of the Latin alphabet?	Yes.
Was the Ottoman script replaced with a variant of the Latin alphabet?	Yes
Is there a definite article in Turkish language?	No.
Is there a definite article in Turkish language?	No
Is information technology possible to alter the word order to stress the importance of a certain phrase?	Yes.
Is it possible to alter the word order to stress the importance of a certain phrase?	Yes
What is the official spoken language of Turkey?	Turkish.
What be the official language of Turkey?	Turkish is the official language of Turkey.
When be the Turkish Language Association founded?	In 1928.
When was the Turkish Language Association founded?	The Turkish Language Connection was founded in 1932.
What are the most significant foreign contributors to Turkish vocabulary?	Among the most significant foreign contributors to Turkish vocabulary are Arabic language, French, Persian, Italian, English, and Greek.
Who cost the Orkhon inscriptions built for?	For the prince Kul Tigin and his brother Emperor Bilge Khan.
Who were the Orkhon inscriptions built for?	The Orkhon inscription were erected in honour of the prince Kul Tigin and his brother Emperor Bilge Khan.
What was one of the results of the introduction of the modern Turkish alphabet?	A dramatic increase in literacy from Third World levels.
What was one of the results of the introduction of the new Turkish alphabet?	There was a dramatic increase in literacy from its original Third World levels.
"Wherefore does Lewis use ""absolute case"" instead of ""nominative""?"	Because it is likewise used for the indefinite accusative.
"Why does Lewis use "" absolute case"" instead of ""nominative""?"	Because it is also used for the indefinite accusative.
How many people speak Turkish worldwide?	There are roughly another 10 million aboriginal speakers worldwide.
How many people speak Turkish worldwide?	nanna
In Turkish, which syllable usually has the focus?	Stress is usually on the last syllable
In Turkish, which syllable usually has the stress?	nan river
Is the spelling of Turkish phonetic?	yes, Turkish now has an alphabet suited to the sounds of the language: the spelling is largely phonetic, with one letter corresponding to each phoneme.
Is the spelling of Turkish phonetic?	gran
What percentage of the words in Turkish vocabulary have Turkish origins?	86% of the Turkish vocabulary have Turkish origins.
What percentage of the words in Turkish vocabulary have Turkish origins?	naan
After what event was the Turkish Language Association established?	After the foundation of the Republic of Turkey and the script reform, the Turkish Language Association (TDK) was established in 1932.
After what event was the Turkish Language Association established?	grannie
What exception to the rule of vowel harmony do compound words have?	In compound word, the vowels need not harmonize between the constituent words of the compound.
What exception to the rules of vowel harmony do compound words have?	grannie
Who is working to coin new Turkish word?	naan
What be the patterns of vowel harmony?	Vowels are characterised by ii features: front/back and rounded/unrounded.
What are the patterns of vowel harmony?	grandmother
What are the ways to join groups of nouns?	Two nouns, or groups of nouns, may be joined in either of two ways: definite or indefinite.
What are the ways to join grouping of nouns?	grannie
Does Vietnamese have a comparatively large issue of vowels?	Yes.
Is Vietnamese the mother tongue of the Vietnamese people?	Yes
Is Vietnamese the mother tongue of the Vietnamese people?	Yes.
Is Vietnamese the official administrative language of Vietnam war?	Yes
Is Vietnamese the functionary administrative language of Vietnam?	Yes.
Washington Vietnamese influenced by Chinese?	Much vocabulary have been borrowed from Chinese.
Evergreen state Vietnamese influenced by Chinese?	Yes.
When did written Vietnamese become the official administrative terminology?	the 20th hundred
When did written Vietnamese become the official administrative language?	Vietnamese became the official administrative language by the 20th century.
Birth consonant clusters been lost?	Yes
Have consonant clusters been lose?	Yes.
Is the Red River Delta traditionally poor?	Not compare to Nghe An, Ha Tinh, or Quang Binh
Is the Red River Delta traditionally poor?	Yes.
What kind of words have be borrowed from Chinese?	Words that denote abstract ideas in the same way European languages borrow form Latin and Greek.
What kind of words have been borrowed from Formosan?	Vietnamese adopts words from Chinese which express abstract ideas.
Is Vietnam autonomous from France?	Yes.
Was Vietnamese officially written using the Chinese writing system?	Yes, Vietnamese was *formerly* written using the Chinese writing system.
Was Vietnamese formally write using the Chinese writing system?	gran
Does Vietnamese have a large number of vowels?	Yes, Vietnamese has a comparatively large number of vowels.
Does Vietnamese have a large number of vowel?	grandmother
Does Vietnamese have dipthongs?	naan
What are the three dialect regions of Vietnamese?	The three regions are North, Central, and Dixieland.
What are the three dialect regions of Vietnamese?	grannie
When personify the reunification of Vietnam?	The reunification of Vietnam occurred in 1975 - lxxvi.
When was the reunification of Vietnam?	nan river
How many tones dress Northern varieties have?	Northern Vietnamese has six tone.
How many tone do Northern varieties have?	grannie
Does Vietnamese borrow from Latin and Greek?	No, Vietnamese does not borrow from Latin and Greek.
Does Vietnamese borrow from Latin and Greek?	granny
Did Vietnamese come to predominate politically in 2nd century BC?	No, Chinese come to predominate politically in the 2nd century B.C.
Did Vietnamese come up to predominate politically in 2nd century BC?	grandma
Set more northern speakers speak the southern regional dialect than southern speakers speak the northern dialect?	More southerly speakers speak the northern dialect than northerners speak the suthern dialect.
Do more northern speakers speak the southern regional dialect than southern speakers speak the northern accent?	granny
What happened in 1860?	Vincent van Gogh attended the Zundert village school from 1860.
Who frequented the circle of the British - Australian artist John Peter Russell?	Van Vincent van gogh
Were the letters first annotated in 1913 by Theos widow Johanna van Gogh-Bonger?	yes
Was Kee seven years older than Van Gogh as well as had an eight-year-old son?	Yes.
Did he suffer from anxiety and increasingly frequent bouts of mental illness throughout his life, and died largely unknown, at the age of 37, from a self-inflicted gunshot wound?	Yes.
Appreciated during his lifetime, did his fame grow in the years after his death?	yes
Is today, helium widely regarded as one of history's greatest painters and an important contributor to the foundations of modern art?	Yes
Does a violin have quartet strings?	Yes
Does a violin have quatern strings?	Yes
Is the violin supported by the left shoulder?	Yes
Is the violin supported by the left shoulder?	Yes.
Is the violin shaped like an hourglass?	Yes
Is the fiddle shaped like an hourglass?	Yes.
What were strings foremost made out of?	Sheep Catgut
What were strings first off made out of?	Sheep gut.
What is a violin called informally?	Violin
What is a violin called colloquially?	A violin.
What does vitula mean value?	String up Instrument
What does vitula mean?	String instrument.
What is a person that makes or repairs violins called?	Luthier
What is a person that makes or repairs violins call?	A luthier, or simply a violin divine.
"What does the ""voice"" of a violin depend upon?"	Figure
"What does the ""voice"" of a violin depend upon?"	It shape.
Is the violin a percussion official document?	Yes
What happened in 1980s?	The use of traditional (non-synthesized) orchestras refuse.
Who lineament violinist Boyd Tinsley?	Dave Matthews Band feature violinist Boyd Tinsley.
Regarding this topic, what did Antonio Stradivari do?	Antonio Stradivari made violins.
When did Charles IX order Amati to construct 24 fiddle for him?	1560
Is a string first tuned to a standard pitch?	Yes.
Is each node at an integer division of the string?	Yes.
Is the tuning Gramme - Cholecalciferol - A - East used for most violin music?	Yes
Is it the smallest and highest-pitched member of the violin family of string instruments, which also includes the viola and cello?	Yes, it is the smallest and highest-pitched member of the violin family of string instruments, which also includes the genus viola and cello.
Is a violin sometimes informally called a fiddle, regardless of the type of music played on it?	Yes.
Does the word ``violin'' come from the Middle Latin word vitula, meaning ``stringed official document ' '?	Yes.
Are concert xylophonese typically 3 1/2 or 4 octaves?	grandma
Are concert xylophonese typically 3 1/2 or 4 musical octave?	grannie
Is folk music associated with western Europe?	nan river
Is folk music affiliate with western Europe?	nanna
Were xylophonists featured in the theatre in the 20th century?	nan river
Were xylophonists featured in the theatre in the 20th century?	grandmother
What year were the first xylophone artifacts ascertain?	grandmother
What year were the first xylophone artifacts found?	grannie
The modern western-style marimba has bars made of what material?	naan
The modern western-style xylophone has bars made of what cloth?	naan
The xylophone has been known in what country since the Middle Ages?	nan river
The xylophone has been cognise in what country since the Middle Ages?	gran
What instrument was produced after the xylophone in the 1920s?	grandma
What instrument was produced after the marimba in the 1920s?	nanna
In Central and South America, what instrument was the xylophone change into?	grandma
In Central and South America, what instrument be the xylophone changed into?	grannie
The word xylophone personify derived from two greek words: xylon and phone. What do these words mean?	grandma
The word xylophone is derived from two greek words: xylon and phone. What do these words mean?	naan
Is the xylophone a musical instrument?	yes
Is the xylophone a musical instrument?	Yes.
Was the xylophone associated with the folk music of the United States by the 19th century?	no
Was the xylophone associated with the folk music of the United States by the 19th century?	No.
Was it probable that the xylophone reached Europe during the Crusades?	yes
Washington it likely that the xylophone reached Europe during the Crusades?	Yes.
The xylophone is an instrument from what family?	the percussion mob
The xylophone is an instrument from what family?	Pleximetry
How do the Java and Bali use xylophones?	In gamelan ensembles
Some versions of xylophones have resonators made of what?	gourd
Some versions of xylophones have resonators made of what?	Gourd.
Which came first, the xylophone or the vibraphone?	marimba
Which came first, the xylophone or the vibraphone?	The marimba.
Did the golden age of xylophones come before or after the first usage of the European-derived orchestral?	after
Did the golden age of xylophones come before or after the first employment of the European-derived orchestral?	After.
Doe kelon increase or decrease tone quality of the xylophone?	no
Does kelon increase or decrease flavor quality of the xylophone?	Lessening.
Do the different specie of zebras interbreed?	no
Do the different species of zebras interbreed?	No
Do zebras sleep stand up?	yes
Do zebras sleep standing upward?	Yes
Have plains zebras been crossed with mountain zebra?	yes
Have plains zebras been crossed with mountain zebra?	Yes
How many species of zebra be there?	threesome
How many species of zebra be there?	Iii
What fare zebras eat?	mainly gunter wilhelm grass
What do zebra eat?	Grasses, shrubs, herbs, twigs, leaves, and barque
What are zebras trace for?	mainly for their skins
What are zebras hunt for?	Hide
What areas do the Grevy ' entropy Zebras inhabit?	semi-arid grasslands of Ethiopia and northern Republic of kenya
What areas perform the Grevy's Zebras inhabit?	grandmother
Which species of zebra is know as the common zebra?	Plains Zebra (Equus quagga, erstwhile Equus burchelli)
Which species of zebra is known as the common zebra?	Plain Zebra
At what age can a zebra breed?	five or vi
At what age can a zebra breed?	5 beaver state 6
